Aag[re]en	"O:? - g R %e:? n	"O:? - g R %a:? n
Aag[re]n	"O:? - g R %e:? n	"O:? - g R %a:? n
Abdol[re]za	A b $ d 6 l $ R "e: $ s a	A b $ d 6 l $ R "a: $ s a
Abildg[re]n	"a $ b i l - g R %e:? n	"a $ b i l - g R %a:? n
Aggerg[re]n	"A $ g 6 - g R %e:? n	"A $ g 6 - g R %a:? n
Ahlg[re]en	"a: l - g R %e:? n	"a: l - g R %a:? n
Ahlg[re]n	"a: l - g R %e:? n	"a: l - g R %a:? n
Akyü[re]k	A $ k j y $ R "e g	A $ k j y $ R "a g
Alb[re]cht	"a l - b R %e g d	"a l - b R %a g d
Alb[re]chtsen	"a l? $ b R %e g d $ s @ n	"a l? $ b R %a g d $ s @ n
Alb[re]chtslund	a l $ b R e g d s - l "O n?	a l $ b R a g d s - l "O n?
Alb[re]ctsen	"a l? $ b R e g d $ s @ n	"a l? $ b R a g d $ s @ n
Alb[re]kt	"a l? $ b R e g d	"a l? $ b R a g d
Alb[re]ktsen	"a l? $ b R e g d $ s @ n	"a l? $ b R a g d $ s @ n
Alb[re]t	"a l? $ b R %e d	"a l? $ b R %a d
Alf[re]do	a l $ f R "e: $ d o	a l $ f R "a: $ d o
Alg[re]en	"a l - g R %e:? n	"a l - g R %a:? n
Alg[re]en-Petersen	a l $ g R e: n - p "e:? $ d 6 $ s @ n	a l $ g R a: n - p "e:? $ d 6 $ s @ n
Alg[re]en-Ussing	a l $ g R e: n - "u $ s e N	a l $ g R a: n - "u $ s e N
Alg[re]n	"a l - g R %e:? n	"a l - g R %a:? n
Alg[re]nsen	"a l $ g R %e:? n $ s @ n	"a l $ g R %a:? n $ s @ n
Ali[re]za	a $ l i $ R "e: $ s a	a $ l i $ R "a: $ s a
Alle[re]lli	"a $ l @ $ R %e $ l i	"a $ l @ $ R %a $ l i
And[re]a	a n $ d R "e: $ a	a n $ d R "a: $ a
And[re]as	a n $ d R "e: $ a s	a n $ d R "a: $ a s
And[re]as	a n $ d R "e:? $ a s	a n $ d R "a:? $ a s
And[re]asen	a n $ d R "e:? $ a $ s @ n	a n $ d R "a:? $ a $ s @ n
And[re]assen	a n $ d R "e:? $ a $ s @ n	a n $ d R "a:? $ a $ s @ n
And[re]asson	a n $ d R "e:? $ a $ s 6 n	a n $ d R "a:? $ a $ s 6 n
And[re]e	a n $ d R "e	a n $ d R "a
And[re]s	a n $ d R "e s	a n $ d R "a s
And[re]sen	"a n $ d R %e:? $ s @ n	"a n $ d R %a:? $ s @ n
And[re]æ	A n $ d R "e $ E	A n $ d R "a $ E
Ane-G[re]the	a: $ n @ - g R "e: $ d @	a: $ n @ - g R "a: $ d @
Ann-G[re]te	a n - g R "e: $ d @	a n - g R "a: $ d @
Ann-G[re]the	a n - g R "e: $ d @	a n - g R "a: $ d @
Ann-Marg[re]the	a n - m A $ g R "e:? $ d @	a n - m A $ g R "a:? $ d @
Ann-Me[re]te	a n - m e $ R "e:? $ d @	a n - m e $ R "a:? $ d @
Anna-G[re]te	a $ n a - g R "e: $ d @	a $ n a - g R "a: $ d @
Anna-G[re]the	a $ n a - g R "e: $ d @	a $ n a - g R "a: $ d @
Anna-Marg[re]the	a $ n a - m A $ g R "e:? $ d @	a $ n a - m A $ g R "a:? $ d @
Annag[re]te	a $ n a - g R "e: $ d @	a $ n a - g R "a: $ d @
Annag[re]the	a $ n a - g R "e: $ d @	a $ n a - g R "a: $ d @
Anne-G[re]te	a $ n @ - g R "e: $ d @	a $ n @ - g R "a: $ d @
Anne-G[re]the	a $ n @ - g R "e: $ d @	a $ n @ - g R "a: $ d @
Anne-Marg[re]the	a $ n @ - m A $ g R "e:? $ d @	a $ n @ - m A $ g R "a:? $ d @
Anne-Me[re]te	a $ n @ - m E $ R "e:? $ d @	a $ n @ - m E $ R "a:? $ d @
Anne-g[re]te	a $ n @ - g R "e: $ d @	a $ n @ - g R "a: $ d @
Anneg[re]t	a $ n @ - g R "e d	a $ n @ - g R "a d
Anneg[re]te	a $ n @ - g R "e: $ d @	a $ n @ - g R "a: $ d @
Anneg[re]the	a $ n @ - g R "e: $ d @	a $ n @ - g R "a: $ d @
Appelg[re]n	"A $ b @ l - g R %e:? n	"A $ b @ l - g R %a:? n
A[re]fe	A $ R "e $ f @	A $ R "a $ f @
Askeng[re]n	"a $ s g @ n - g R %e:? n	"a $ s g @ n - g R %a:? n
Au[re]lia	A w $ R "e:? l $ j a	A w $ R "a:? l $ j a
Bek[re]m	b e $ k R "e m	b e $ k R "a m
Be[re]dskabsstyrelsen	b e $ R "e D? - s g a: b s - s d %y: $ 6 l $ s @ n	b e $ R "a D? - s g a: b s - s d %y: $ 6 l $ s @ n
Be[re]te	b e $ R "e:? $ d @	b e $ R "a:? $ d @
Bergg[re]en	b "E6 w - g R %e:? n	b "E6 w - g R %a:? n
Bergg[re]ensgade	b "E6 w - g R e: n s - g %a: D $ @	b "E6 w - g R a: n s - g %a: D $ @
Bergg[re]n	b "E6 w - g R %e:? n	b "E6 w - g R %a:? n
Bermudat[re]kanten	b E6 $ m "u: $ d a - t R e - k %a n? $ d @ n	b E6 $ m "u: $ d a - t R a - k %a n? $ d @ n
Blomg[re]en	b l "6 m - g R %e:? n	b l "6 m - g R %a:? n
Blomg[re]n	b l "6 m - g R %e:? n	b l "6 m - g R %a:? n
Blommeg[re]nen	b l "6 $ m @ - g R %e:? $ n @ n	b l "6 $ m @ - g R %a:? $ n @ n
Boels[re]v	b "o:? l s - R %e w	b "o:? l s - R %a w
Bold[re]el	b "6 l $ d R %e:? l	b "6 l $ d R %a:? l
Bolmg[re]n	b "6 l m - g R %e:? n	b "6 l m - g R %a:? n
Bonn-[re]geringen	b "6 n - R @ $ g %e:? $ R e N? $ @ n	b "6 n - R @ $ g %e:? $ R a N? $ @ n
B[re]d	b R "e D	b R "a D
B[re]d	b R "e D?	b R "a D?
B[re]dagerløkken	b R "e D - a: $ 6 - l %2 $ g @ n	b R "a D - a: $ 6 - l %2 $ g @ n
B[re]dahl	b R "e:? - d %a:? l	b R "a:? - d %a:? l
B[re]dahlsvej	b R "e:? - d a: l s - v %A j?	b R "a:? - d a: l s - v %A j?
B[re]dal	b R "e - d %a:? l	b R "a - d %a:? l
B[re]dalsvej	b R "e:? - d a: l s - v %A j?	b R "a:? - d a: l s - v %A j?
B[re]dballe	b R "e D - b %a $ l @	b R "a D - b %a $ l @
B[re]dballestrand	b R e D - b a $ l @ - s d R "A n?	b R a D - b a $ l @ - s d R "A n?
B[re]dberg	b R "e D - b %E6?	b R "a D - b %E6?
B[re]dbjerg	b R "e D - b j %E6?	b R "a D - b j %E6?
B[re]dbjergvej	b R "e D - b j E6 - v %A j?	b R "a D - b j E6 - v %A j?
B[re]ddal	b R "e D - d %a:? l	b R "a D - d %a:? l
B[re]ddam	b R "e D - d %A m?	b R "a D - d %A m?
B[re]de	b R "e: D $ @	b R "a: D $ @
B[re]debjerg	b R "e: D $ @ - b j %E6?	b R "a: D $ @ - b j %E6?
B[re]debo	b R "e: D $ @ - b %o:?	b R "a: D $ @ - b %o:?
B[re]debro	b R e: D $ @ - b R "o:?	b R a: D $ @ - b R "o:?
B[re]degade	b R "e: D $ @ - g %a: D $ @	b R "a: D $ @ - g %a: D $ @
B[re]degrund	b R "e: D $ @ - g R %O n?	b R "a: D $ @ - g R %O n?
B[re]deholm	b R "e: D $ @ - h %6 l? m	b R "a: D $ @ - h %6 l? m
B[re]dekilde	b R "e: D $ @ - k %i $ l @	b R "a: D $ @ - k %i $ l @
B[re]deland	b R "e: D $ @ - l %a n?	b R "a: D $ @ - l %a n?
B[re]delandsvej	b R "e: D $ @ - l a n s - v %A j?	b R "a: D $ @ - l a n s - v %A j?
B[re]deløkke	b R "e: D $ @ - l %2 $ g @	b R "a: D $ @ - l %2 $ g @
B[re]deng	b R "e D - %E N?	b R "a D - %E N?
B[re]dengen	b R "e D - %E N? $ @ n	b R "a D - %E N? $ @ n
B[re]derød	b R "e: D $ @ - R %2 D?	b R "a: D $ @ - R %2 D?
B[re]des	b R "e: D $ @ s	b R "a: D $ @ s
B[re]desande	b R "e: D $ @ - s %a $ n @	b R "a: D $ @ - s %a $ n @
B[re]desen	b R "e: D $ @ $ s @ n	b R "a: D $ @ $ s @ n
B[re]deshave	b R "e: D $ @ s - h %a: $ v @	b R "a: D $ @ s - h %a: $ v @
B[re]detved	b R "e D? $ @ - d v %e D	b R "a D? $ @ - d v %e D
B[re]devad	b R "e: D $ @ - v %a D	b R "a: D $ @ - v %a D
B[re]devandsbakker	b R e D $ @ - v a n s - b "A $ g 6	b R a D $ @ - v a n s - b "A $ g 6
B[re]devang	b R "e: D $ @ - v %A N?	b R "a: D $ @ - v %A N?
B[re]devej	b R "e: D $ @ - v %A j?	b R "a: D $ @ - v %A j?
B[re]dfald	b R "e D - f %a l?	b R "a D - f %a l?
B[re]dfjed	b R "e D - f j %e D	b R "a D - f j %e D
B[re]dgaard	b R "e D - g %Q:?	b R "a D - g %Q:?
B[re]dgade	b R "e D - g %a: D $ @	b R "a D - g %a: D $ @
B[re]dhage	b R "e D - h %a: $ @	b R "a D - h %a: $ @
B[re]dho	b R "e D - h %o:?	b R "a D - h %o:?
B[re]dholm	b R "e D - h %6 l? m	b R "a D - h %6 l? m
B[re]dholt	b R "e D - h %6 l? d	b R "a D - h %6 l? d
B[re]dholtskov	b R e D - h 6 l d - s g "6 w?	b R a D - h 6 l d - s g "6 w?
B[re]dholtvej	b R "e D - h 6 l d - v %A j?	b R "a D - h 6 l d - v %A j?
B[re]dhøj	b R "e D - h %6 j?	b R "a D - h %6 j?
B[re]dingsgyden	b R "e: D $ e N s - g %y: D $ @ n	b R "a: D $ e N s - g %y: D $ @ n
B[re]dkildegade	b R "e D - k i $ l @ - g %a: D $ @	b R "a D - k i $ l @ - g %a: D $ @
B[re]dkjær	b R "e D - k %E6?	b R "a D - k %E6?
B[re]dkær	b R "e D - k %E6?	b R "a D - k %E6?
B[re]dkærparken	b R "e D - k E6 - p %A: $ g @ n	b R "a D - k E6 - p %A: $ g @ n
B[re]dkærvej	b R "e D - k E6 - v %A j?	b R "a D - k E6 - v %A j?
B[re]dlund	b R "e D - l %O n?	b R "a D - l %O n?
B[re]dlænge	b R "e D - l %E N $ @	b R "a D - l %E N $ @
B[re]dmose	b R "e D - m %o: $ s @	b R "a D - m %o: $ s @
B[re]dning	b R "e D $ n e N	b R "a D $ n e N
B[re]dningen	b R "e D $ n %e N? $ @ n	b R "a D $ n %e N? $ @ n
B[re]do	b R "e: $ d o	b R "a: $ d o
B[re]dsgaard	b R "e D? s - g %Q:?	b R "a D? s - g %Q:?
B[re]dsgårde	b R "e D? s - g %Q: $ 6	b R "a D? s - g %Q: $ 6
B[re]dsig	b R "e D $ s %i:?	b R "a D $ s %i:?
B[re]dskiftevej	b R "e D - s g i f $ d @ - v %A j?	b R "a D - s g i f $ d @ - v %A j?
B[re]dsted	b R "e D - s d %E D	b R "a D - s d %E D
B[re]dstedgade	b R "e D - s d E D - g %a: D $ @	b R "a D - s d E D - g %a: D $ @
B[re]dsten	b R "e $ s d @ n	b R "a $ s d @ n
B[re]dsten	b R "e D - s d %e:? n	b R "a D - s d %e:? n
B[re]dstenlund	b R e: $ s d @ n - l "O n?	b R a: $ s d @ n - l "O n?
B[re]dstrup	b R "e D? $ s d R %O b	b R "a D? $ s d R %O b
B[re]dstruplund	b R "e D? $ s d R O b - l %O n?	b R "a D? $ s d R O b - l %O n?
B[re]dtoft	b R "e D - t %6 f d	b R "a D - t %6 f d
B[re]dtofte	b R "e D - t %Q f $ d @	b R "a D - t %Q f $ d @
B[re]dtved	b R "e D - d v %e D	b R "a D - d v %e D
B[re]dvadmølle	b R "e D - v a D - m %2 $ l @	b R "a D - v a D - m %2 $ l @
B[re]dvig	b R "e D $ v %i:?	b R "a D $ v %i:?
B[re]dvig	b R "e D - v %i:?	b R "a D - v %i:?
B[re]ed	b R "e D?	b R "a D?
B[re]ede	b R "e D $ @	b R "a D $ @
B[re]elte	b R "e:? $ @ l $ d @	b R "a:? $ @ l $ d @
B[re]er	b R "e:? $ 6	b R "a:? $ 6
B[re]genborg	b R "e: $ @ n - b %Q:?	b R "a: $ @ n - b %Q:?
B[re]gendahl	b R "e: $ @ n - d %a:? l	b R "a: $ @ n - d %a:? l
B[re]gengaard	b R "e:? $ @ n - g %Q:?	b R "a:? $ @ n - g %Q:?
B[re]genov	b R "e: $ @ $ n 6 w	b R "a: $ @ $ n 6 w
B[re]gentved	b R "e:? $ @ n - d v %e D	b R "a:? $ @ n - d v %e D
B[re]gentvedvej	b R "e:? $ @ n - d v @ D - v %A j?	b R "a:? $ @ n - d v @ D - v %A j?
B[re]hmer	b R "e:? $ m 6	b R "a:? $ m 6
B[re]ko	b R "e: $ k o	b R "a: $ k o
B[re]men	b R "e:? $ m @ n	b R "a:? $ m @ n
B[re]mens	b R "e:? $ m e n s	b R "a:? $ m e n s
B[re]mensgade	b R "e:? $ m E n s - g %a: D $ @	b R "a:? $ m E n s - g %a: D $ @
B[re]mer	b R "e:? $ m 6	b R "a:? $ m 6
B[re]merhage	b R "e:? $ m 6 - h %a: $ @	b R "a:? $ m 6 - h %a: $ @
B[re]merhaven	b R e $ m 6 - h "A: $ f e n	b R a $ m 6 - h "A: $ f e n
B[re]merholm	b R "e:? $ m 6 - h %6 l? m	b R "a:? $ m 6 - h %6 l? m
B[re]merskov	b R "e:? $ m 6 - s g %6 w?	b R "a:? $ m 6 - s g %6 w?
B[re]merstent	b R "e:? $ m 6 $ s d %E n d	b R "a:? $ m 6 $ s d %E n d
B[re]merstente	b R "e:? $ m 6 $ s d %E n $ d @	b R "a:? $ m 6 $ s d %E n $ d @
B[re]mersvold	b R "e:? $ m 6 s - v %6 l?	b R "a:? $ m 6 s - v %6 l?
B[re]mland	b R "e m - l %a n?	b R "a m - l %a n?
B[re]nda	b R "e n $ d a	b R "a n $ d a
B[re]ndan	b R "e n $ d a n	b R "a n $ d a n
B[re]nøe	b R "e: $ n %2:?	b R "a: $ n %2:?
B[re]semann	b R "e: $ s @ - m %A n	b R "a: $ s @ - m %A n
B[re]slaugade	b R "e $ s l A w - g %a: D $ @	b R "a $ s l A w - g %a: D $ @
B[re]sson	b R e $ s "6 N	b R a $ s "6 N
B[re]stenbro	b R e: $ s d @ n - b R "o:?	b R a: $ s d @ n - b R "o:?
B[re]tagne	b R e $ t "a $ n j @	b R a $ t "a $ n j @
B[re]tagnevej	b R e $ t "a $ n j @ - v %A j?	b R a $ t "a $ n j @ - v %A j?
B[re]th	b R "e d	b R "a d
B[re]thvad	b R "e $ d v %a D	b R "a $ d v %a D
B[re]tt	b R "e d	b R "a d
B[re]ttschneider	b R "e d $ S n %A j $ d 6	b R "a d $ S n %A j $ d 6
B[re]um	b R "e: $ O m	b R "a: $ O m
B[re]umbanke	b R e: $ O m - b "A N $ g @	b R a: $ O m - b "A N $ g @
B[re]umlund	b R e $ O m - l "O n?	b R a $ O m - l "O n?
B[re]vadt	b R "e: $ v a d	b R "a: $ v a d
Bur[re]n	b "9 $ R e n	b "9 $ R a n
Caba[re]te	k A $ b A $ R "e $ t @	k A $ b A $ R "a $ t @
Cartier-b[re]sson	k A $ t j e - b R e $ s "6 N	k A $ t j e - b R a $ s "6 N
Cast[re]s	k "a $ s d R e	k "a $ s d R a
Ch[re]sten	k R "e $ s d @ n	k R "a $ s d @ n
Ch[re]stensen	k R "e $ s d @ n $ s @ n	k R "a $ s d @ n $ s @ n
Ch[re]stina	k R e $ s d "i: $ n a	k R a $ s d "i: $ n a
Ch[re]stine	k R e $ s d "i:? $ n @	k R a $ s d "i:? $ n @
Cæsa[re]a	s E $ s A $ R "e: $ a	s E $ s A $ R "a: $ a
Dahlg[re]en	d "a l - g R %e:? n	d "a l - g R %a:? n
Dahlg[re]n	d "a l - g R %e:? n	d "a l - g R %a:? n
Damg[re]en	d "A m - g R %e:? n	d "A m - g R %a:? n
Damg[re]n	d "A m - g R %e:? n	d "A m - g R %a:? n
Danb[re]v	d "a n - b R %e w?	d "a n - b R %a w?
Dellg[re]n	d "E l - g R %e:? n	d "E l - g R %a:? n
Desi[re]	d e $ s i $ R "e	d e $ s i $ R "a
Desi[re]e	d e $ s i $ R "e	d e $ s i $ R "a
Dizda[re]vic	d i $ s d A $ R "e: $ v i d S	d i $ s d A $ R "a: $ v i d S
Do[re]te	d o $ R "e:? $ d @	d o $ R "a:? $ d @
Do[re]the	d o $ R "e:? $ d @	d o $ R "a:? $ d @
D[re]chselsgade	d R "e g $ s e l s - g %a: D $ @	d R "a g $ s e l s - g %a: D $ @
D[re]esen	d R "e: $ s @ n	d R "a: $ s @ n
D[re]s	d R "e:? s	d R "a:? s
D[re]scher	d R "e $ S 6	d R "a $ S 6
D[re]sden	d R "e:? $ s d @ n	d R "a:? $ s d @ n
D[re]sen	d R "e:? $ s @ n	d R "a:? $ s @ n
D[re]sler	d R "e $ s l 6	d R "a $ s l 6
D[re]ssler	d R "e $ s l 6	d R "a $ s l 6
D[re]wes	d R "e: $ v @ s	d R "a: $ v @ s
D[re]ws	d R "e w? s	d R "a w? s
D[re]wsensvej	d R "e w? $ s @ n s - v %A j?	d R "a w? $ s @ n s - v %A j?
Due[re]d	d "u: $ @ - R %e D	d "u: $ @ - R %a D
Dy[re]d	d "y: $ R %e D?	d "y: $ R %a D?
Edb-ud[re]dningsudvalget	e: $ d e: $ b "e:? - u D ~ R e D? $ n e N s - u D ~ v %a l? $ @ D	e: $ d e: $ b "e:? - u D ~ R a D? $ n e N s - u D ~ v %a l? $ @ D
Eggeb[re]cht	"E $ g @ - b R %e g d	"E $ g @ - b R %a g d
Ek[re]m	"E $ g R e m	"E $ g R a m
Ellen-Marg[re]the	E $ l @ n - m A $ g R "e:? $ d @	E $ l @ n - m A $ g R "a:? $ d @
Elmg[re]en	"E l m - g R %e:? n	"E l m - g R %a:? n
Else-Marg[re]the	E l $ s @ - m A $ g R "e:? $ d @	E l $ s @ - m A $ g R "a:? $ d @
Eme[re]k	"E: $ m e $ R %e g	"E: $ m e $ R %a g
E[re]ne	e $ R "e: $ n @	e $ R "a: $ n @
Erit[re]a	e6 $ i $ t R "e: $ a	e6 $ i $ t R "a: $ a
Ext[re]madura	E g $ s d R e $ m a $ d "u: $ A	E g $ s d R a $ m a $ d "u: $ A
Fahlg[re]n	f "a: l - g R %e:? n	f "a: l - g R %a:? n
Fah[re]ttin	f A $ R "e $ d i n	f A $ R "a $ d i n
Falg[re]n	f "a l - g R %e:? n	f "a l - g R %a:? n
Fa[re]s	f "A: $ R %e s	f "A: $ R %a s
Fe[re]nc	f "E $ R %e n d s	f "E $ R %a n d s
Fik[re]ta	f i $ k R "e $ t a	f i $ k R "a $ t a
Firkløver[re]geringen	f "i6 - k l 2: $ v 6 - R @ $ g %e:? $ R e N? $ @ n	f "i6 - k l 2: $ v 6 - R @ $ g %e:? $ R a N? $ @ n
For[re]st	f "Q $ R %e s d	f "Q $ R %a s d
F[re]d	f R "e d	f R "a d
F[re]dberg	f R "e D - b %E6?	f R "a D - b %E6?
F[re]dbjerg	f R "e D - b j %E6?	f R "a D - b j %E6?
F[re]dborg	f R "e D - b %Q:?	f R "a D - b %Q:?
F[re]ddi	f R "e $ d i	f R "a $ d i
F[re]ddie	f R "e $ d i	f R "a $ d i
F[re]ddy	f R "e $ d y	f R "a $ d y
F[re]ddys	f R "e $ d y s	f R "a $ d y s
F[re]de	f R "e: D $ @	f R "a: D $ @
F[re]dell	f R e $ d "E l	f R a $ d "E l
F[re]demarksvej	f R "e: D $ @ - m A: g s - v %A j?	f R "a: D $ @ - m A: g s - v %A j?
F[re]den	f R "e D? $ @ n	f R "a D? $ @ n
F[re]densberg	f R "e D? $ @ n s - b %E6?	f R "a D? $ @ n s - b %E6?
F[re]densbjerg	f R "e D? $ @ n s - b j %E6?	f R "a D? $ @ n s - b j %E6?
F[re]densbo	f R "e D? $ @ n s - b %o:?	f R "a D? $ @ n s - b %o:?
F[re]densborg	f R "e D? $ @ n s - b %Q:?	f R "a D? $ @ n s - b %Q:?
F[re]densborg-Humlebæk	f R e D $ @ n s - b Q - h "O m $ l @ - b %E g	f R a D $ @ n s - b Q - h "O m $ l @ - b %E g
F[re]densborg-humlebæk	f R e D $ @ n s - b Q - h "O m $ l @ - b %E g	f R a D $ @ n s - b Q - h "O m $ l @ - b %E g
F[re]densborggade	f R e D $ @ n s - b "Q:? - g %a: D $ @	f R a D $ @ n s - b "Q:? - g %a: D $ @
F[re]densborgvej	f R e D $ @ n s - b "Q:? - v %A j?	f R a D $ @ n s - b "Q:? - v %A j?
F[re]densdal	f R "e D? $ @ n s - d %a:? l	f R "a D? $ @ n s - d %a:? l
F[re]densgade	f R "e D? $ @ n s - g %a: D $ @	f R "a D? $ @ n s - g %a: D $ @
F[re]densgårdsvej	f R e D $ @ n s - g "Q:? s - v %A j?	f R a D $ @ n s - g "Q:? s - v %A j?
F[re]denshøj	f R "e D? $ @ n s - h %6 j?	f R "a D? $ @ n s - h %6 j?
F[re]denslund	f R "e D? $ @ n s - l %O n?	f R "a D? $ @ n s - l %O n?
F[re]denslyst	f R "e D? $ @ n s - l %2 s d	f R "a D? $ @ n s - l %2 s d
F[re]densvang	f R "e D? $ @ n s - v %A N?	f R "a D? $ @ n s - v %A N?
F[re]densvej	f R "e D? $ @ n s - v %A j?	f R "a D? $ @ n s - v %A j?
F[re]deric	f R "e $ d e $ R e g	f R "a $ d e $ R e g
F[re]derica	f R "e D $ @ $ R %i: $ g a	f R "a D $ @ $ R %i: $ g a
F[re]derichsen	f R "e D? $ @ $ R %e g $ s @ n	f R "a D? $ @ $ R %e g $ s @ n
F[re]dericia	f R e D $ @ $ R "e $ S a	f R a D $ @ $ R "e $ S a
F[re]dericia-Middelfart	f R e D $ @ $ R e d $ S a - m "i D? $ @ l - f %A:? d	f R a D $ @ $ R e d $ S a - m "i D? $ @ l - f %A:? d
F[re]dericiagade	f R e D $ @ $ R "e d $ S a - g %a: D $ @	f R a D $ @ $ R "e d $ S a - g %a: D $ @
F[re]dericias	f R e D $ @ $ R "e d $ S a s	f R a D $ @ $ R "e d $ S a s
F[re]dericiaskolen	f R e D $ @ $ R "e $ S a - s g %o: $ l @ n	f R a D $ @ $ R "e $ S a - s g %o: $ l @ n
F[re]dericiavej	f R e D $ @ $ R "e d $ S a - v %A j?	f R a D $ @ $ R "e d $ S a - v %A j?
F[re]derik	f R "e D $ @ $ R e g	f R "a D $ @ $ R e g
F[re]derikke	f R e D $ @ $ R "e $ g @	f R a D $ @ $ R "e $ g @
F[re]derikkehøj	f R e D $ @ $ R "e $ g @ - h %6 j?	f R a D $ @ $ R "e $ g @ - h %6 j?
F[re]deriks	f R "e D? $ @ $ R e g s	f R "a D? $ @ $ R e g s
F[re]deriksberg	f R e D $ @ $ R e g s - b "E6?	f R a D $ @ $ R e g s - b "E6?
F[re]deriksberggade	f R e D $ @ $ R e g s - b "E6? - g %a: D $ @	f R a D $ @ $ R e g s - b "E6? - g %a: D $ @
F[re]deriksbergs	f R e D $ @ $ R e g s - b "E6? s	f R a D $ @ $ R e g s - b "E6? s
F[re]deriksborg	f R e D $ @ $ R e g s - b "Q:?	f R a D $ @ $ R e g s - b "Q:?
F[re]deriksborggade	f R e D $ @ $ R e g s - b "Q:? - g %a: D $ @	f R a D $ @ $ R e g s - b "Q:? - g %a: D $ @
F[re]deriksborgs	f R e D $ @ $ R e g s - b "Q:? s	f R a D $ @ $ R e g s - b "Q:? s
F[re]deriksborgvej	f R e D $ @ $ R e g s - b "Q:? - v %A j?	f R a D $ @ $ R e g s - b "Q:? - v %A j?
F[re]deriksdal	f R e D $ @ $ R e g s - d "a:? l	f R a D $ @ $ R e g s - d "a:? l
F[re]derikseg	f R e D $ @ $ R e g s - "e:?	f R a D $ @ $ R e g s - "e:?
F[re]deriksen	f R "e D? $ @ $ R %e g $ s @ n	f R "a D? $ @ $ R %e g $ s @ n
F[re]deriksens	f R "e D? $ @ $ R e g $ s @ n s	f R "a D? $ @ $ R e g $ s @ n s
F[re]deriksgade	f R "e D? $ @ $ R e g s - g %a: D $ @	f R "a D? $ @ $ R e g s - g %a: D $ @
F[re]deriksgave	f R e D $ @ $ R e g s - g "a: $ v @	f R a D $ @ $ R e g s - g "a: $ v @
F[re]deriksgård	f R e D $ @ $ R e g s - g "Q:?	f R a D $ @ $ R e g s - g "Q:?
F[re]derikshald	f R e D $ @ $ R e g s - h "a l?	f R a D $ @ $ R e g s - h "a l?
F[re]derikshaldsgade	f R e D $ @ $ R e g s - h "a l? s - g %a: D $ @	f R a D $ @ $ R e g s - h "a l? s - g %a: D $ @
F[re]derikshave	f R e D $ @ $ R e g s - h "a: $ v @	f R a D $ @ $ R e g s - h "a: $ v @
F[re]derikshavn	f R e D $ @ $ R e g s - h "A w? n	f R a D $ @ $ R e g s - h "A w? n
F[re]derikshavns	f R e D $ @ $ R e g s - h "A w? n s	f R a D $ @ $ R e g s - h "A w? n s
F[re]derikshavnsvej	f R e D $ @ $ R e g s - h "A w? n s - v %A j?	f R a D $ @ $ R e g s - h "A w? n s - v %A j?
F[re]deriksholm	f R e D $ @ $ R e g s - h "6 l? m	f R a D $ @ $ R e g s - h "6 l? m
F[re]deriksholms	f R e D $ @ $ R e g s - h "6 l? m s	f R a D $ @ $ R e g s - h "6 l? m s
F[re]deriksholmsvej	f R e D $ @ $ R e g s - h "6 l? m s - v %A j?	f R a D $ @ $ R e g s - h "6 l? m s - v %A j?
F[re]derikshåb	f R e D $ @ $ R e g s - h "O:? b	f R a D $ @ $ R e g s - h "O:? b
F[re]derikshøj	f R e D $ @ $ R e g s - h "6 j?	f R a D $ @ $ R e g s - h "6 j?
F[re]derikshøjvej	f R e D $ @ $ R e g s - h "6 j - v %A j?	f R a D $ @ $ R e g s - h "6 j - v %A j?
F[re]derikskaj	f R e D $ @ $ R e g s - k "A j?	f R a D $ @ $ R e g s - k "A j?
F[re]derikskildevej	f R e D $ @ $ R e g s - k "i $ l @ - v %A j?	f R a D $ @ $ R e g s - k "i $ l @ - v %A j?
F[re]derikslund	f R e D $ @ $ R e g s - l "O n?	f R a D $ @ $ R e g s - l "O n?
F[re]deriksminde	f R e D $ @ $ R e g s - m "e $ n @	f R a D $ @ $ R e g s - m "e $ n @
F[re]deriksmose	f R "e D? $ @ $ R e g s - m %o: $ s @	f R "a D? $ @ $ R e g s - m %o: $ s @
F[re]deriksnåde	f R e D $ @ $ R e g s - n "O: D $ @	f R a D $ @ $ R e g s - n "O: D $ @
F[re]deriksodde	f R e D $ @ $ R e g s - "6 D $ @	f R a D $ @ $ R e g s - "6 D $ @
F[re]deriksson	f R "e D? $ R e g $ s %o:? n	f R "a D? $ R e g $ s %o:? n
F[re]deriksstad	f R e D $ @ $ R e g s - s d "a D	f R a D $ @ $ R e g s - s d "a D
F[re]deriksstadsgade	f R "e D? $ @ $ R e g s - s d a D s - g %a: D $ @	f R "a D? $ @ $ R e g s - s d a D s - g %a: D $ @
F[re]derikssted	f R e D $ @ $ R e g s - s d "E D	f R a D $ @ $ R e g s - s d "E D
F[re]derikssund	f R e D $ @ $ R e g - s "O n?	f R a D $ @ $ R e g - s "O n?
F[re]derikssunds	f R e D $ @ $ R e g s - s "O n? s	f R a D $ @ $ R e g s - s "O n? s
F[re]derikssundsvej	f R e D $ @ $ R e g - s "O n? s - v %A j?	f R a D $ @ $ R e g - s "O n? s - v %A j?
F[re]derikstorv	f R e D $ @ $ R e g s - t "Q w?	f R a D $ @ $ R e g s - t "Q w?
F[re]deriksvej	f R "e D $ @ $ R e g s - v %A j?	f R "a D $ @ $ R e g s - v %A j?
F[re]deriksværk	f R e D $ @ $ R e g s - v "E6 g	f R a D $ @ $ R e g s - v "E6 g
F[re]deriksværks	f R e D $ @ $ R e g s - v "E6 g s	f R a D $ @ $ R e g s - v "E6 g s
F[re]deriksværksgade	f R e D $ @ $ R e g s - v "E6 g s - g %a: D $ @	f R a D $ @ $ R e g s - v "E6 g s - g %a: D $ @
F[re]deriksø	f R e D $ @ $ R e g $ s "2:?	f R a D $ @ $ R e g $ s "2:?
F[re]des	f R "e: D $ @ s	f R "a: D $ @ s
F[re]dgaard	f R "e D - g %Q:?	f R "a D - g %Q:?
F[re]dholm	f R "e D - h %6 l? m	f R "a D - h %6 l? m
F[re]dmans	f R "e D - m %a n? s	f R "a D - m %a n? s
F[re]dmose	f R "e D - m %o: $ s @	f R "a D - m %o: $ s @
F[re]dningsnævnet	f R "e D $ n e N s - n %E w? $ n @ D	f R "a D $ n e N s - n %E w? $ n @ D
F[re]drik	f R "e D? $ R e g	f R "a D? $ R e g
F[re]driksen	f R "e D? $ R @ g $ s @ n	f R "a D? $ R @ g $ s @ n
F[re]driksson	f R "e:? D $ R e g $ s %o:? n	f R "a:? D $ R e g $ s %o:? n
F[re]drikstadvej	f R e D $ @ $ R e g - s d "a D - v %A j?	f R a D $ @ $ R e g - s d "a D - v %A j?
F[re]dsgaard	f R "e D s - g %Q:?	f R "a D s - g %Q:?
F[re]dsgårde	f R "e D s - g %Q: $ 6	f R "a D s - g %Q: $ 6
F[re]dsholm	f R "e D s - h %6 l? m	f R "a D s - h %6 l? m
F[re]dskild	f R "e D $ s g %i l?	f R "a D $ s g %i l?
F[re]dskov	f R "e D - s g %6 w?	f R "a D - s g %6 w?
F[re]dskoven	f R "e D - s g %6 w? $ @ n	f R "a D - s g %6 w? $ @ n
F[re]dskovhellet	f R "e D - s g 6 w - h %E $ l @ D	f R "a D - s g 6 w - h %E $ l @ D
F[re]dskovvej	f R "e D - s g 6 w - v %A j?	f R "a D - s g 6 w - v %A j?
F[re]dslund	f R "e D s - l %O n?	f R "a D s - l %O n?
F[re]dsted	f R "e D - s d %E D	f R "a D - s d %E D
F[re]dsvænget	f R "e D s - v %E N $ @ D	f R "a D s - v %E N $ @ D
F[re]dsø	f R "e D $ s %2:?	f R "a D $ s %2:?
F[re]dsøe	f R "e D $ s %2:?	f R "a D $ s %2:?
F[re]dtofte	f R "e D - t %6 f $ d @	f R "a D - t %6 f $ d @
F[re]dy	f R "e $ d i	f R "a $ d i
F[re]erslev	f R "e6 $ s l %e w	f R "a6 $ s l %e w
F[re]ersvang	f R "e6 s - v %A N?	f R "a6 s - v %A N?
F[re]ersvangsvej	f R "e:? $ 6 s - v A N s - v %A j?	f R "a:? $ 6 s - v A N s - v %A j?
F[re]es	f R "e:? s	f R "a:? s
F[re]ese	f R "e: $ s @	f R "a: $ s @
F[re]gerslev	f R "e:? $ 6 $ s l %e w	f R "a:? $ 6 $ s l %e w
F[re]mmelev	f R "e $ m @ $ l %e w	f R "a $ m @ $ l %e w
F[re]mming	f R "e $ m e N	f R "a $ m e N
F[re]nderup	f R "e $ n @ $ R %O b	f R "a $ n @ $ R %O b
F[re]nderupgård	f R e $ n @ $ R O b - g "Q:?	f R a $ n @ $ R O b - g "Q:?
F[re]ndstrup	f R "e n? $ s d R %O b	f R "a n? $ s d R %O b
F[re]ngler	f R "e N? $ l 6	f R "a N? $ l 6
F[re]se	f R "e: $ s @	f R "a: $ s @
F[re]siavej	f R "e:? $ S a - v %A j?	f R "a:? $ S a - v %A j?
F[re]strup	f R "e $ s d R %O b	f R "a $ s d R %O b
Gholam[re]za	h "o $ l 6 m - R e $ s %A	h "o $ l 6 m - R a $ s %A
Godtf[re]dsen	g "6 d $ f R %e d $ s @ n	g "6 d $ f R %a d $ s @ n
Go[re]cki	g o $ R "e $ k i	g o $ R "a $ k i
Gotf[re]d	g "6 d $ f R %e D	g "6 d $ f R %a D
Gotf[re]dsen	g "6 d $ f R %e D $ s @ n	g "6 d $ f R %a D $ s @ n
Gottf[re]dsen	g "6 d $ f R %e D $ s @ n	g "6 d $ f R %a D $ s @ n
G[re]bjerg	g R "e:? - b j %E6?	g R "a:? - b j %E6?
G[re]dal	g R "e:? - d %a:? l	g R "a:? - d %a:? l
G[re]dsted	g R "e D - s d %E D	g R "a D - s d %E D
G[re]dstedbro	g R e - s d E D - b R "o:?	g R a - s d E D - b R "o:?
G[re]en	g R "e:? n	g R "a:? n
G[re]ffel	g R "e $ f @ l	g R "a $ f @ l
G[re]ger	g R "e:? $ g 6	g R "a:? $ g 6
G[re]gers	g R "e:? $ g 6 s	g R "a:? $ g 6 s
G[re]gersen	g R "e:? $ g 6 $ s @ n	g R "a:? $ g 6 $ s @ n
G[re]gor	g R "e:? $ g Q	g R "a:? $ g Q
G[re]gorius	g R e $ g "o6? $ j u s	g R a $ g "o6? $ j u s
G[re]n	g R "e:? n	g R "a:? n
G[re]naa	g R "e: $ n %O:?	g R "a: $ n %O:?
G[re]naae	g R "e: $ n %O:?	g R "a: $ n %O:?
G[re]nadinerne	g R e $ n a $ d "i:? $ n 6 $ n @	g R a $ n a $ d "i:? $ n 6 $ n @
G[re]ne	g R "e: $ n @	g R "a: $ n @
G[re]nen	g R "e:? $ n @ n	g R "a:? $ n @ n
G[re]noble	g R e $ n "6 $ b l @	g R a $ n "6 $ b l @
G[re]nsholm	g R "e:? n s - h %6 l? m	g R "a:? n s - h %6 l? m
G[re]nå	g R "e: $ n %O:?	g R "a: $ n %O:?
G[re]nåen	g R "e: n - %O:? $ @ n	g R "a: n - %O:? $ @ n
G[re]någade	g R "e: $ n O: - g %a: D $ @	g R "a: $ n O: - g %a: D $ @
G[re]nåvej	g R "e: $ n O: - v %A j?	g R "a: $ n O: - v %A j?
G[re]sted	g R "e:? - s d %E D	g R "a:? - s d %E D
G[re]ta	g R "e: $ t a	g R "a: $ t a
G[re]tbjerg	g R "e d - b j %E6?	g R "a d - b j %E6?
G[re]tchen	g R "e: d $ S @ n	g R "a: d $ S @ n
G[re]te	g R "e: $ d @	g R "a: $ d @
G[re]tel	g R "e: $ t @ l	g R "a: $ t @ l
G[re]tevej	g R "e: $ d @ - v %A j?	g R "a: $ d @ - v %A j?
G[re]th	g R "e:? d	g R "a:? d
G[re]tha	g R "e: $ t a	g R "a: $ t a
G[re]the	g R "e: $ d @	g R "a: $ d @
G[re]thesvej	g R "e: $ d @ s - v %A j?	g R "a: $ d @ s - v %A j?
G[re]ve	g R "e: $ v @	g R "a: $ v @
G[re]velodden	g R "e $ v @ - l %6 D? $ @ n	g R "a $ v @ - l %6 D? $ @ n
G[re]velsbakke	g R "e:? $ v e l s - b %A $ g @	g R "a:? $ v e l s - b %A $ g @
G[re]velshøj	g R "e:? $ v e l s - h %6 j?	g R "a:? $ v e l s - h %6 j?
G[re]velund	g R "e: $ v @ - l %O n?	g R "a: $ v @ - l %O n?
G[re]vensvænge	g R e: $ v @ n s - v "E N $ @	g R a: $ v @ n s - v "E N $ @
G[re]vindeskov	g R e w $ "e $ n @ - s g %6 w?	g R a w $ "e $ n @ - s g %6 w?
G[re]vinge	g R "e: $ v e N $ @	g R "a: $ v e N $ @
G[re]vingevej	g R "e: $ v e N $ @ - v %A j?	g R "a: $ v e N $ @ - v %A j?
G[re]vsen	g R "e w? $ s @ n	g R "a w? $ s @ n
G[re]vy	g R e $ v "i	g R a $ v "i
Gråbrød[re]stræde	g R "6 - b R 2 D $ R 6 - s d R %e: D $ @	g R "6 - b R 2 D $ R 6 - s d R %a: D $ @
Gærdeb[re]d	g "E: $ 6 - b R %e D	g "E: $ 6 - b R %a D
Gülse[re]n	g y l $ s e $ R "e n	g y l $ s e $ R "a n
Hagg[re]n	h "a: - g R %e:? n	h "a: - g R %a:? n
Hajda[re]vic	h A j $ d "A $ R e $ v %i d S	h A j $ d "A $ R a $ v %i d S
Halg[re]en	h "a l - g R %e:? n	h "a l - g R %a:? n
Halg[re]ensgade	h "a l - g R e: n s - g %a: D $ @	h "a l - g R a: n s - g %a: D $ @
Halleng[re]en	h "a $ l @ n - g R %e:? n	h "a $ l @ n - g R %a:? n
Halleng[re]n	h "a $ l @ n - g R %e:? n	h "a $ l @ n - g R %a:? n
Hallg[re]en	h "a l - g R %e:? n	h "a l - g R %a:? n
Hallg[re]n	h "a l - g R %e:? n	h "a l - g R %a:? n
Halv[re]bene	h "a l - R %e:? $ b @ $ n @	h "a l - R %a:? $ b @ $ n @
Hamid[re]za	h A $ m "i d - R %e $ s A	h A $ m "i d - R %a $ s A
Haneb[re]d	h "a: $ n @ - b R %e D	h "a: $ n @ - b R %a D
Hanne-G[re]te	h a $ n @ - g R "e: $ d @	h a $ n @ - g R "a: $ d @
Hanne-G[re]the	h a $ n @ - g R "e: $ d @	h a $ n @ - g R "a: $ d @
Ha[re]springet	h "A: $ 6 - s b R %e N? $ @ D	h "A: $ 6 - s b R %a N? $ @ D
Hay[re]ttin	h "A j $ R e $ t i n	h "A j $ R a $ t i n
Helb[re]chtskær	h E l - b R e g d s - k "E6?	h E l - b R a g d s - k "E6?
Helligt[re]konger	h E $ l i - t R e: - k "6 N $ 6	h E $ l i - t R a: - k "6 N $ 6
Helligt[re]kongershøj	h E $ l i - t R e: - k "6 N $ 6 s - h %6 j?	h E $ l i - t R a: - k "6 N $ 6 s - h %6 j?
He[re]tica	h e $ R "e:? $ t i $ k a	h e $ R "a:? $ t i $ k a
Holmf[re]d	h "6 l m $ f R %e D	h "6 l m $ f R %a D
Holmg[re]en	h "6 l m - g R %e:? n	h "6 l m - g R %a:? n
Holmg[re]n	h "6 l m - g R %e:? n	h "6 l m - g R %a:? n
Hono[re]'	h o $ n o $ R "e	h o $ n o $ R "a
Hulg[re]en	h "u: l - g R %e:? n	h "u: l - g R %a:? n
Hulteng[re]n	h "u l $ d @ n - g R %e:? n	h "u l $ d @ n - g R %a:? n
Hultg[re]n	h "u l d - g R %e:? n	h "u l d - g R %a:? n
Hundtofte[re]d	h "u n - t 6 f $ d @ $ R %e D	h "u n - t 6 f $ d @ $ R %a D
Inge-G[re]the	e N $ @ - g R "e: $ d @	e N $ @ - g R "a: $ d @
Inge-Marg[re]the	e N $ @ - m A $ g R "e:? $ d @	e N $ @ - m A $ g R "a:? $ d @
Inge-Me[re]te	e N $ @ - m E $ R "e:? $ d @	e N $ @ - m E $ R "a:? $ d @
Inge-Me[re]the	e N $ @ - m E $ R "e:? $ d @	e N $ @ - m E $ R "a:? $ d @
Ingef[re]d	"e N $ @ - f R %e D	"e N $ @ - f R %a D
Inger-Marg[re]the	e N $ 6 - m A $ g R "e:? $ d @	e N $ 6 - m A $ g R "a:? $ d @
Inger-Me[re]te	e N $ 6 - m E $ R "e:? $ d @	e N $ 6 - m E $ R "a:? $ d @
I[re]m	i $ R "e m	i $ R "a m
I[re]n	i $ R "e n	i $ R "a n
I[re]na	i $ R "e: $ n a	i $ R "a: $ n a
I[re]ne	i $ R "e: $ n @	i $ R "a: $ n @
I[re]nes	i $ R "e: $ n @ s	i $ R "a: $ n @ s
I[re]nevej	i $ R "e: $ n @ - v %A j?	i $ R "a: $ n @ - v %A j?
Jasa[re]vic	j a $ s A $ R "e: $ v i d S	j a $ s A $ R "a: $ v i d S
Jespersen-Sk[re]e	j E $ s b 6 $ s @ n - s g R "e:?	j E $ s b 6 $ s @ n - s g R "a:?
Jungg[re]ensvej	j "O N - g R e: n s - v %A j?	j "O N - g R a: n s - v %A j?
Kaczma[re]k	k a $ s m A $ R "e g	k a $ s m A $ R "a g
Ka[re]l	k "A: $ R e l	k "A: $ R a l
Ka[re]len	k A $ R "e:? $ l @ n	k A $ R "a:? $ l @ n
Ka[re]n-Margrete	k A $ 6 n - m A $ g R "e:? $ d @	k A $ 6 n - m A $ g R "a:? $ d @
Ka[re]n-Margrethe	k A: $ 6 n - m A $ g R "e:? $ d @	k A: $ 6 n - m A $ g R "a:? $ d @
Ka[re]tmagergyden	k A $ R "e:? d - m a: $ 6 - g %y: D $ @ n	k A $ R "a:? d - m a: $ 6 - g %y: D $ @ n
Ka[re]tmagerstræde	k A $ R "e:? d - m a: $ 6 - s d R %e: D $ @	k A $ R "a:? d - m a: $ 6 - s d R %e: D $ @
Ka[re]tmagertoften	k A $ R "e:? d - m a: $ 6 - t %6 f $ d @ n	k A $ R "a:? d - m a: $ 6 - t %6 f $ d @ n
Ka[re]tmagervej	k A $ R "e:? d - m a: $ 6 - v %A j?	k A $ R "a:? d - m a: $ 6 - v %A j?
Kat[re]vel	k "a $ d R %e:? $ v @ l	k "a $ d R %a:? $ v @ l
Ke[re]m	k e $ R "e m	k e $ R "a m
Kirsebærg[re]nen	k "i6 $ s @ - b E6 - g R %e:? $ n @ n	k "i6 $ s @ - b E6 - g R %a:? $ n @ n
Ko[re]a	k o $ R "e: $ a	k o $ R "a: $ a
Ko[re]akrigen	k o $ R "e: $ a - k R %i:? $ @ n	k o $ R "a: $ a - k R %i:? $ @ n
Ko[re]as	k o $ R "e: $ a s	k o $ R "a: $ a s
Ko[re]avej	k o $ R "e: $ a - v %A j?	k o $ R "a: $ a - v %A j?
K[re]ditvurderingsinstituttet	k R e $ d "i d - v u6 $ d e6? $ e N s - e n $ s d i $ t %u $ d @ D	k R a $ d "i d - v u6 $ d e6? $ e N s - e n $ s d i $ t %u $ d @ D
K[re]kær	k R "e:? - k %E6?	k R "a:? - k %E6?
K[re]kærvej	k R "e:? - k E6 - v %A j?	k R "a:? - k E6 - v %A j?
K[re]ms	k R "e:? m s	k R "a:? m s
K[re]n	k R "e:? n	k R "a:? n
K[re]nchel	k R "e n? $ S @ l	k R "a n? $ S @ l
K[re]sta	k R "e $ s d a	k R "a $ s d a
K[re]sten	k R "e $ s d @ n	k R "a $ s d @ n
K[re]stian	k R "e $ s d j a n	k R "a $ s d j a n
K[re]stina	k R e $ s d "i: $ n a	k R a $ s d "i: $ n a
K[re]stine	k R e $ s d "i:? $ n @	k R a $ s d "i:? $ n @
K[re]ta	k R "e: $ t a	k R "a: $ t a
K[re]tavej	k R "e: $ t a - v %A j?	k R "a: $ t a - v %A j?
K[re]tzschmar	k R "e d S $ m A	k R "a d S $ m A
Krond[re]vet	k R "o: n - d R %e:? $ v @ D	k R "o: n - d R %a:? $ v @ D
Kud[re]t	k "u $ d R e d	k "u $ d R a d
Ku[re]k	k "u: $ R %e g	k "u: $ R %a g
Laf[re]nz	l "A w $ R %e n s	l "A w $ R %a n s
Lamb[re]cht	l "A m - b R %e g d	l "A m - b R %a g d
Landg[re]be	l "a n $ g R %e: $ b @	l "a n $ g R %a: $ b @
Landg[re]en	l "a n - g R %e:? n	l "a n - g R %a:? n
Landg[re]n	l "a n - g R %e:? n	l "a n - g R %a:? n
Landg[re]ven	l "a n - g R %e: $ v @ n	l "a n - g R %a: $ v @ n
Langf[re]dag	l A N - f R "e:? $ d a	l A N - f R "a:? $ d a
Lau[re]n	l "6 $ R e n	l "6 $ R a n
Lau[re]nt	l "6 $ R %e n d	l "6 $ R %a n d
Lau[re]ntiussen	l A w $ R "e n? $ t j u $ s @ n	l A w $ R "a n? $ t j u $ s @ n
Lau[re]tte	l o $ R "e d	l o $ R "a d
Liberg[re]n	l "i: $ b 6 - g R %e:? n	l "i: $ b 6 - g R %a:? n
Lib[re]ville	l "i $ b R e $ v %i:	l "i $ b R a $ v %i:
Liljeg[re]n	l "i l $ j @ - g R %e:? n	l "i l $ j @ - g R %a:? n
Lindeg[re]n	l "e $ n @ - g R %e:? n	l "e $ n @ - g R %a:? n
Lindg[re]en	l "e n - g R %e: n	l "e n - g R %a: n
Lindg[re]n	l "e n - g R %e:? n	l "e n - g R %a:? n
Ljungg[re]en	l j "O N - g R %e:? n	l j "O N - g R %a:? n
Ljungg[re]n	l j "O N - g R %e:? n	l j "O N - g R %a:? n
Lo[re]na	l Q $ R "e: $ n a	l Q $ R "a: $ n a
Luk[re]tiavej	l u $ k R "e:? $ t j a - v %A j?	l u $ k R "a:? $ t j a - v %A j?
Lundg[re]en	l "O n - g R %e:? n	l "O n - g R %a:? n
Lundg[re]n	l "O n - g R %e:? n	l "O n - g R %a:? n
Lynge-F[re]deriksborg	l 2 N $ @ - f R @ D $ @ $ R e g s - b "Q:?	l 2 N $ @ - f R @ D $ @ $ R a g s - b "Q:?
Lægek[re]dsforeningen	l "E: $ @ - k R e: s - f Q $ %e:? $ n e N? $ @ n	l "E: $ @ - k R a: s - f Q $ %e:? $ n e N? $ @ n
Løfg[re]en	l "2 w - g R %e:? n	l "2 w - g R %a:? n
Løfg[re]n	l "9 f - g R %e:? n	l "9 f - g R %a:? n
Løng[re]en	l "9 n - g R %e:? n	l "9 n - g R %a:? n
Løvg[re]en	l "2 w - g R %e:? n	l "2 w - g R %a:? n
Løvg[re]n	l "2 w - g R %e:? n	l "2 w - g R %a:? n
Mag[re]the	m A $ g R "e:? $ d @	m A $ g R "a:? $ d @
Malmg[re]n	m "a l m - g R %e:? n	m "a l m - g R %a:? n
Marga[re]t	m "A: $ g A $ R %e d	m "A: $ g A $ R %a d
Marga[re]ta	m A $ g A $ R "e: $ t a	m A $ g A $ R "a: $ t a
Marga[re]te	m A $ g A $ R "e:? $ d @	m A $ g A $ R "a:? $ d @
Marga[re]th	m "A: $ g A $ R e d	m "A: $ g A $ R a d
Marga[re]tha	m A $ g A $ R "e: $ t a	m A $ g A $ R "a: $ t a
Marga[re]the	m A $ g A $ R "e:? $ d @	m A $ g A $ R "a:? $ d @
Marg[re]ta	m A $ g R "e: $ t a	m A $ g R "a: $ t a
Marg[re]te	m A $ g R "e:? $ d @	m A $ g R "a:? $ d @
Marg[re]tegård	m A $ g R "e:? $ d @ - g %Q:?	m A $ g R "a:? $ d @ - g %Q:?
Marg[re]tehåb	m A $ g R "e:? $ d @ - h %O:? b	m A $ g R "a:? $ d @ - h %O:? b
Marg[re]telund	m A $ g R "e:? $ d @ - l %O n?	m A $ g R "a:? $ d @ - l %O n?
Marg[re]teshøj	m A $ g R "e:? $ d @ s - h %6 j?	m A $ g R "a:? $ d @ s - h %6 j?
Marg[re]tesminde	m A $ g R e: $ d @ s - m "e $ n @	m A $ g R a: $ d @ s - m "e $ n @
Marg[re]tha	m A $ g R "e: $ t a	m A $ g R "a: $ t a
Marg[re]the	m A $ g R "e:? $ d @	m A $ g R "a:? $ d @
Marg[re]thegården	m A $ g R "e:? $ d @ - g %Q:? $ 6 n	m A $ g R "a:? $ d @ - g %Q:? $ 6 n
Marg[re]theholm	m A $ g R "e:? $ d @ - h %6 l? m	m A $ g R "a:? $ d @ - h %6 l? m
Marg[re]thehåbsvej	m A $ g R "e:? $ d @ - h O: b s - v %A j?	m A $ g R "a:? $ d @ - h O: b s - v %A j?
Marg[re]thehåbsvænget	m A $ g R "e:? $ d @ - h O: b s - v %E N $ @ D	m A $ g R "a:? $ d @ - h O: b s - v %E N $ @ D
Marg[re]thelund	m A $ g R e: $ d @ - l "O n?	m A $ g R a: $ d @ - l "O n?
Marg[re]thepladsen	m A $ g R "e:? $ d @ - p l %a $ s @ n	m A $ g R "a:? $ d @ - p l %a $ s @ n
Marg[re]thes	m A $ g R "e:? $ d @ s	m A $ g R "a:? $ d @ s
Marg[re]thevej	m A $ g R "e:? $ d @ - v %A j?	m A $ g R "a:? $ d @ - v %A j?
Marie-The[re]se	m A $ R i: $ @ - t @ $ R "e: $ s @	m A $ R i: $ @ - t @ $ R "a: $ s @
Me[re]te	m e $ R "e:? $ d @	m e $ R "a:? $ d @
Me[re]tecentret	m e $ R "e:? $ d @ - s %E n? $ d R 6 D	m e $ R "a:? $ d @ - s %E n? $ d R 6 D
Me[re]the	m e $ R "e:? $ d @	m e $ R "a:? $ d @
Mi[re]a	m i $ R "e: $ a	m i $ R "a: $ a
Mi[re]ille	m i $ R "e j	m i $ R "a j
Mi[re]la	m i $ R "e: $ l a	m i $ R "a: $ l a
Mi[re]lla	m i $ R "e $ l a	m i $ R "a $ l a
Mohammad-[re]za	m o $ h A $ m a D - R "e: $ s a	m o $ h A $ m a D - R "a: $ s a
Moo[re]a	m o $ o $ R "e: $ a	m o $ o $ R "a: $ a
Mo[re]no	m 6 $ R "e $ n o	m 6 $ R "a $ n o
Moseb[re]dden	m "o: $ s @ - b R %e D? $ @ n	m "o: $ s @ - b R %a D? $ @ n
Mua[re]mi	m u $ A $ R "e: $ m i	m u $ A $ R "a: $ m i
Muha[re]m	m u $ h "A: $ R e m	m u $ h "A: $ R a m
Muhar[re]m	m u $ h "A $ R e m	m u $ h "A $ R a m
Niek[re]nz	n "i: $ k R %e n? d s	n "i: $ k R %a n? d s
Nordg[re]n	n "o6 - g R %e:? n	n "o6 - g R %a:? n
Nordko[re]a	n "o6 - k o $ R %e: $ a	n "o6 - k o $ R %a: $ a
Nordko[re]as	n "o6 - k o $ R %e: $ a s	n "o6 - k o $ R %a: $ a s
No[re]n	n o $ R "e:? n	n o $ R "a:? n
Nou[re]ddine	n 6 w $ R e $ d "i $ n @	n 6 w $ R a $ d "i $ n @
Nu[re]ttin	n u $ R "e $ t i n	n u $ R "a $ t i n
Nus[re]t	n "u s $ R e d	n "u s $ R a d
Nyg[re]en	n "y: - g R %e:? n	n "y: - g R %a:? n
Nyrup-[re]geringen	n "y6? $ O b - R @ $ g %e:? $ R e N? $ @ n	n "y6? $ O b - R @ $ g %e:? $ R a N? $ @ n
Nørg[re]en	n "96 - g R %e:? n	n "96 - g R %a:? n
Overd[re]v	"6 w $ 6 - d R %e w	"6 w $ 6 - d R %a w
Overd[re]vet	"6 w $ 6 - d R %e:? $ v @ D	"6 w $ 6 - d R %a:? $ v @ D
Overd[re]vshuse	6 w $ 6 - d R e w s - h "u: $ s @	6 w $ 6 - d R a w s - h "u: $ s @
Overd[re]vsvej	"6 w $ 6 - d R e w s - v %A j?	"6 w $ 6 - d R a w s - v %A j?
Overd[re]vsvejen	"6 w $ 6 - d R e w s - v %A j? $ @ n	"6 w $ 6 - d R a w s - v %A j? $ @ n
Palmg[re]n	p "a l m - g R %e:? n	p "a l m - g R %a:? n
Pa[re]lius	p A $ R "e:? $ l i $ u s	p A $ R "a:? $ l i $ u s
Pe[re]	p e $ R "e	p e $ R "a
Pe[re]z	p "E: $ R e s	p "E: $ R a s
Pet[re]a	p e $ t R "e: $ a	p e $ t R "a: $ a
Polder[re]v	p "6 $ l 6 - R %e w	p "6 $ l 6 - R %a w
P[re]ben	p R "e:? $ b @ n	p R "a:? $ b @ n
P[re]bensen	p R "e:? $ b @ n $ s @ n	p R "a:? $ b @ n $ s @ n
P[re]bensgård	p R "e:? $ b @ n s - g %Q:?	p R "a:? $ b @ n s - g %Q:?
P[re]drag	p R "e $ d R %A w	p R "a $ d R %A w
P[re]etzmann	p R "e: d s - m %A n	p R "a: d s - m %A n
P[re]gaard	p R "e - g %Q:?	p R "a - g %Q:?
P[re]hn	p R "e:? n	p R "a:? n
P[re]miair	p R "e $ m i $ %E6	p R "a $ m i $ %E6
P[re]mier	p R e $ m j "e	p R a $ m j "e
P[re]sleys	p R "e $ s l i s	p R "a $ s l i s
P[re]tlove	p R "e d - l %O: w $ @	p R "a d - l %O: w $ @
P[re]toria	p R e $ t "o6? $ j a	p R a $ t "o6? $ j a
P[re]tzmann	p R "e d s - m %A n	p R "a d s - m %A n
P[re]vin	p R "e $ v e n	p R "a $ v e n
Pæ[re]grenen	p "E: $ 6 - g R %e:? $ n @ n	p "E: $ 6 - g R %a:? $ n @ n
Qu[re]shi	k u $ R "e $ S i	k u $ R "a $ S i
[re]VA-Fyn	R e: $ v a - f "y:? n	R a: $ v a - f "y:? n
[re]a	R "e: $ a	R "a: $ a
[re]ading	R "e $ d e N	R "a $ d e N
[re]aldanmark	R e $ "a:? l - d %a n $ m A g	R a $ "a:? l - d %a n $ m A g
[re]alkredit	R e $ "a:? l - k R @ $ d %i d	R a $ "a:? l - k R @ $ d %i d
[re]alkreditloven	R e $ "a:? l - k R @ $ d i d - l %O:? $ v @ n	R a $ "a:? l - k R @ $ d i d - l %O:? $ v @ n
[re]alkreditrådets	R e $ "a:? l - k R @ $ d i d - R %O:? D $ @ D s	R a $ "a:? l - k R @ $ d i d - R %O:? D $ @ D s
[re]bbelsgrave	R "e $ b @ l $ s g R %A: $ v @	R "a $ b @ l $ s g R %A: $ v @
[re]bbøl	R "e $ b %2 l	R "a $ b %2 l
[re]becca	R e $ b "E $ k a	R a $ b "E $ k a
[re]becka	R e $ b "E $ k a	R a $ b "E $ k a
[re]bekka	R e $ b "E $ g a	R a $ b "E $ g a
[re]bekkavej	R e $ b "E $ g a - v %A j?	R a $ b "E $ g a - v %A j?
[re]bels	R e $ b "E l? s	R a $ b "E l? s
[re]belsig	R "e:? $ b @ l $ s %i:?	R "a:? $ b @ l $ s %i:?
[re]berbanegade	R "e: $ b 6 - b a: $ n @ - g %a: D $ @	R "a: $ b 6 - b a: $ n @ - g %a: D $ @
[re]berbansgade	R "e: $ b 6 - b a: n s - g %a: D $ @	R "a: $ b 6 - b a: n s - g %a: D $ @
[re]berne	R "e: $ b 6 $ n @	R "a: $ b 6 $ n @
[re]bien	R "e: $ b %i:? n	R "a: $ b %i:? n
[re]bild	R "e: $ b %i l?	R "a: $ b %i l?
[re]bildparken	R "e: $ b i l - p %A: $ g @ n	R "a: $ b i l - p %A: $ g @ n
[re]bildtved	R "e: $ b i l - d v %e D	R "a: $ b i l - d v %e D
[re]bildvej	R "e: $ b i l - v %A j?	R "a: $ b i l - v %A j?
[re]bsdorf	R "e b s - d %Q: f	R "a b s - d %Q: f
[re]bsenge	R "e:? b s - %E N $ @	R "a:? b s - %E N $ @
[re]bslagervej	R "e: b - s l a: $ 6 - v %A j?	R "a: b - s l a: $ 6 - v %A j?
[re]bstrup	R "e b $ s d R %O b	R "a b $ s d R %O b
[re]bæk	R "e - b %E g	R "a - b %E g
[re]cep	R "e $ s E b	R "a $ s E b
[re]da	R "e $ d a	R "a $ d a
[re]da	R "e: $ d a	R "a: $ d a
[re]dder	R "e D $ 6	R "a D $ 6
[re]deligheden	R "e: D $ @ $ l i - h %e D? $ @ n	R "a: D $ @ $ l i - h %e D? $ @ n
[re]deriforeningen	R e D $ @ $ R "i - f Q $ %e:? $ n e N? $ @ n	R a D $ @ $ R "i - f Q $ %e:? $ n e N? $ @ n
[re]deriforeningens	R e D $ @ $ R "i - f Q $ %e:? $ n e N? $ @ n s	R a D $ @ $ R "i - f Q $ %e:? $ n e N? $ @ n s
[re]dha	R "e: $ d a	R "a: $ d a
[re]dhavnsvej	R "e D - h A w n s - v %A j?	R "a D - h A w n s - v %A j?
[re]dke	R "e d $ g @	R "a d $ g @
[re]dmolen	R "e D - m %o: $ l @ n	R "a D - m %o: $ l @ n
[re]dsted	R "e - s d %E D	R "a - s d %E D
[re]dsø	R "e D $ s %2:?	R "a D $ s %2:?
[re]dsøhede	R "e D $ s 2: - h %e: D $ @	R "a D $ s 2: - h %e: D $ @
[re]dzep	R "e d $ s e b	R "a d $ s e b
[re]dzepi	R e d $ s "E $ b i	R a d $ s "E $ b i
[re]e	R "e:?	R "a:?
[re]edtz	R "e:? d s	R "a:? d s
[re]eh	R "e:?	R "a:?
[re]em	R "e: m	R "a: m
[re]enberg	R "e: n - b %E6?	R "a: n - b %E6?
[re]erslev	R "e6? $ s l %e w	R "a6? $ s l %e w
[re]ersnæs	R "e6? s - n %E s	R "a6? s - n %E s
[re]erstrup	R "e6? $ s d R %O b	R "a6? $ s d R %O b
[re]ersø	R "e6? $ s %2:?	R "a6? $ s %2:?
[re]ersøgade	R "e: $ 6 $ s 2: - g %a: D $ @	R "a: $ 6 $ s 2: - g %a: D $ @
[re]ese	R "e: $ s @	R "a: $ s @
[re]esen	R "e: $ s @ n	R "a: $ s @ n
[re]eslev	R "e:? $ s l %e w	R "a:? $ s l %e w
[re]etz	R "e:? d s	R "a:? d s
[re]eves	R "e: $ v @ s	R "a: $ v @ s
[re]fer	R "e:? $ f 6	R "a:? $ f 6
[re]fik	R "e $ f %i g	R "a $ f %i g
[re]fika	R e $ f "i $ k a	R a $ f "i $ k a
[re]fn	R "e f n	R "a f n
[re]fnov	R "e $ f n %6 w	R "a $ f n %6 w
[re]formationens	R e $ f Q $ m a $ S "o:? $ n @ n s	R a $ f Q $ m a $ S "o:? $ n @ n s
[re]frigeration	R e $ f R i $ d j e $ R "E j $ S e n	R a $ f R i $ d j e $ R "E j $ S e n
[re]fs	R "e f s	R "a f s
[re]fsager	R "e f $ s %a:? $ 6	R "a f $ s %a:? $ 6
[re]fsbøl	R "e f s - b %2 l	R "a f s - b %2 l
[re]fshaleøen	R "e f s - h a $ l @ - %2:? $ @ n	R "a f s - h a $ l @ - %2:? $ @ n
[re]fshaleøens	R "e f s - h a $ l @ - %2:? $ @ n s	R "a f s - h a $ l @ - %2:? $ @ n s
[re]fshammer	R "e f s - h %A m? $ 6	R "a f s - h %A m? $ 6
[re]fsnæsskolen	R "e f s - n E s - s g %o: $ l @ n	R "a f s - n E s - s g %o: $ l @ n
[re]fsvindinge	R e f $ s v "e $ n e N $ @	R a f $ s v "e $ n e N $ @
[re]gel	R "e: $ @ l	R "a: $ @ l
[re]gel	R "e:? $ @ l	R "a:? $ @ l
[re]genburgsgade	R "e: $ @ n - b u6 s - g %a: D $ @	R "a: $ @ n - b u6 s - g %a: D $ @
[re]genburgsvej	R "e: $ @ n - b u6 s - v %A j?	R "a: $ @ n - b u6 s - v %A j?
[re]geringschefens	R e $ g "e6? $ e N s - S %E:? $ f @ n s	R a $ g "e6? $ e N s - S %E:? $ f @ n s
[re]gerup	R "e: $ @ $ R %O b	R "a: $ @ $ R %O b
[re]gin	R "e $ g %i n	R "a $ g %i n
[re]gina	R e $ g "i: $ n a	R a $ g "i: $ n a
[re]gine	R e $ g "i: $ n @	R a $ g "i: $ n @
[re]ginehøjvej	R e $ g "i: $ n @ - h 6 j - v %A j?	R a $ g "i: $ n @ - h 6 j - v %A j?
[re]gisse	R e $ g "i $ s @	R a $ g "i $ s @
[re]gistertilsynet	R e $ g "i $ s d 6 - t e l ~ s %y:? $ n @ D	R a $ g "i $ s d 6 - t e l ~ s %y:? $ n @ D
[re]gitse	R e $ g "i d $ s @	R a $ g "i d $ s @
[re]gitsevej	R e $ g "i d $ s @ - v %A j?	R a $ g "i d $ s @ - v %A j?
[re]gitze	R "e $ g i d $ s @	R "a $ g i d $ s @
[re]gstrup	R "e:? $ s d R %O b	R "a:? $ s d R %O b
[re]hana	R e $ h "a $ n a	R a $ h "a $ n a
[re]hder	R "e: $ d 6	R "a: $ d 6
[re]her	R "e:? $ 6	R "a:? $ 6
[re]hfeld	R "e: - f %E l? d	R "a: - f %E l? d
[re]hling	R "e: $ l e N	R "a: $ l e N
[re]hman	R "e:? - m %a n?	R "a:? - m %a n?
[re]hmeier	R "e:? - m %A j? $ 6	R "a:? - m %A j? $ 6
[re]hn	R "e:? n	R "a:? n
[re]hne	R "e $ n @	R "a $ n @
[re]hnquist	R "e: n - k v %e s d	R "a: n - k v %e s d
[re]hr	R "e6?	R "a6?
[re]ims	R "e N	R "a N
[re]ine	R "e: n	R "a: n
[re]inettevej	R e $ n "E $ d @ - v %A j?	R a $ n "E $ d @ - v %A j?
[re]ker	R "e:? $ g 6	R "a:? $ g 6
[re]ma	R "e: $ m a	R "a: $ m a
[re]mee	R e $ m "i:	R a $ m "i:
[re]mfeldt	R "e m - f %E l? d	R "a m - f %E l? d
[re]mi	R "e: $ m i	R "a: $ m i
[re]miseparken	R e $ m "i: $ s @ - p %A: $ g @ n	R a $ m "i: $ s @ - p %A: $ g @ n
[re]misevej	R e $ m "i: $ s @ - v %A j?	R a $ m "i: $ s @ - v %A j?
[re]mo	R "e: $ m O	R "a: $ m O
[re]my	R "e: $ m i	R "a: $ m i
[re]na	R "e: $ n a	R "a: $ n a
[re]naissancen	R e $ n @ $ s "A N $ s @ n	R a $ n @ $ s "A N $ s @ n
[re]nard	R e $ n "A:	R a $ n "A:
[re]nata	R e $ n "a $ t a	R a $ n "a $ t a
[re]nate	R e $ n "a: $ d @	R a $ n "a: $ d @
[re]nato	R e $ n "a $ t o	R a $ n "a $ t o
[re]nault	R e $ n "o	R a $ n "o
[re]nbækgård	R "e: n - b E g - g %Q:?	R "a: n - b E g - g %Q:?
[re]ne	R e $ n "e	R a $ n "e
[re]nee	R e $ n "i:	R a $ n "i:
[re]nehuse	R "e: $ n @ - h %u: $ s @	R "a: $ n @ - h %u: $ s @
[re]ni	R e $ n "i	R a $ n "i
[re]nnes	R "e n	R "a n
[re]nnison	R "e $ n i $ s %6 n	R "a $ n i $ s %6 n
[re]nny	R "e $ n i	R "a $ n i
[re]no	R "e: $ n o	R "a: $ n o
[re]nsdyrløkken	R "e: n s - d y6 - l %2 $ g @ n	R "a: n s - d y6 - l %2 $ g @ n
[re]nsdyrvej	R "e: n s - d y6 - v %A j?	R "a: n s - d y6 - v %A j?
[re]nè	R e $ n "e	R a $ n "e
[re]né	R e $ n "e	R a $ n "e
[re]née	R e $ n "e	R a $ n "e
[re]portageholdet	R e $ p Q $ t "a: $ S @ - h %6 l? $ @ D	R a $ p Q $ t "a: $ S @ - h %6 l? $ @ D
[re]rup	R "e6? $ O b	R "a6? $ O b
[re]sat	R e $ s "a d	R a $ s "a d
[re]sdal	R "e s - d %a:? l	R "a s - d %a:? l
[re]sedavej	R e $ s "e: $ d a - v %A j?	R a $ s "e: $ d a - v %A j?
[re]seke	R "e: $ s @ $ k @	R "a: $ s @ $ k @
[re]sen	R "e: $ s @ n	R "a: $ s @ n
[re]senborg	R "e: $ s @ n - b %Q:?	R "a: $ s @ n - b %Q:?
[re]senbro	R "e: $ s @ n - b R %o:?	R "a: $ s @ n - b R %o:?
[re]senby	R "e: $ s @ n - b %y:?	R "a: $ s @ n - b %y:?
[re]sendal	R "e: $ s @ n - d %a:? l	R "a: $ s @ n - d %a:? l
[re]senfelde	R "e: $ s @ n - f %E l $ d @	R "a: $ s @ n - f %E l $ d @
[re]sengårdvej	R "e: $ s @ n - g Q: - v %A j?	R "a: $ s @ n - g Q: - v %A j?
[re]senstad	R "e: $ s @ n - s d %a D	R "a: $ s @ n - s d %a D
[re]senvej	R "e: $ s @ n - v %A j?	R "a: $ s @ n - v %A j?
[re]serveofficersforeningen	R e $ s "E6 $ v @ - 6 $ f i $ s e6 s - f Q $ %e:? $ n e N? $ @ n	R a $ s "E6 $ v @ - 6 $ f i $ s e6 s - f Q $ %e:? $ n e N? $ @ n
[re]sleskov	R "e $ s l @ - s g %6 w?	R "a $ s l @ - s g %6 w?
[re]staurantskolen	R e $ s d o $ R "A N - s g %o: $ l @ n	R a $ s d o $ R "A N - s g %o: $ l @ n
[re]sted	R "e - s d %E D	R "a - s d %E D
[re]storff	R "e: s $ t %Q: f	R "a: s $ t %Q: f
[re]sul	R e $ s "u l	R a $ s "u l
[re]thymnon	R e $ t "y m $ n 6 n	R a $ t "y m $ n 6 n
[re]toft	R "e - t %6 f d	R "a - t %6 f d
[re]tortvej	R e $ t "Q: d - v %A j?	R a $ t "Q: d - v %A j?
[re]va-Centret	R "e: $ v a - s %E n? $ d R 6 D	R "a: $ v a - s %E n? $ d R 6 D
[re]vald	R "e: $ v %a l? d	R "a: $ v %a l? d
[re]valgade	R "e: $ v a l - g %a: D $ @	R "a: $ v a l - g %a: D $ @
[re]valideringsklinikken	R e $ v a $ l i $ d "e6? $ e N s - k l i $ n %i $ g @ n	R a $ v a $ l i $ d "e6? $ e N s - k l i $ n %i $ g @ n
[re]veldrup	R "e:? $ v @ l $ d R %O b	R "a:? $ v @ l $ d R %O b
[re]velhøjvej	R "e:? $ v @ l - h 6 j - v %A j?	R "a:? $ v @ l - h 6 j - v %A j?
[re]ventlow	R "e:? $ v e n d $ l %6 w	R "a:? $ v e n d $ l %6 w
[re]ventlowsgade	R "e:? $ v e n d $ l 6 w s - g %a: D $ @	R "a:? $ v e n d $ l 6 w s - g %a: D $ @
[re]ventlowsvej	R "e:? $ v e n d $ l 6 w s - v %A j?	R "a:? $ v e n d $ l 6 w s - v %A j?
[re]verdilsgade	R "e: $ v 6 $ d i l s - g %a: D $ @	R "a: $ v 6 $ d i l s - g %a: D $ @
[re]vet	R "e:? $ v @ D	R "a:? $ v @ D
[re]visionsfirmaet	R e $ v i $ S "o:? n s - f %i6 $ m a:? $ @ D	R a $ v i $ S "o:? n s - f %i6 $ m a:? $ @ D
[re]visionsinstituttet	R e $ v i $ S "o:? n s - e n $ s d i $ t %u $ d @ D	R a $ v i $ S "o:? n s - e n $ s d i $ t %u $ d @ D
[re]visionsrettens	R e $ v i $ S "o:? n s - R %E $ d @ n s	R a $ v i $ S "o:? n s - R %E $ d @ n s
[re]vitse	R "e $ v %i d $ s @	R "a $ v %i d $ s @
[re]vkrog	R "e w - k R %O w?	R "a w - k R %O w?
[re]vn	R "e w? n	R "a w? n
[re]vsbech	R "e w? s - b %E g	R "a w? s - b %E g
[re]vsbeck	R "e w? s - b %E g	R "a w? s - b %E g
[re]vsbæk	R "e w? s - b %E g	R "a w? s - b %E g
[re]vsgård	R "e w? s - g %Q:?	R "a w? s - g %Q:?
[re]vsgårdlund	R e w s - g Q: - l "O n?	R a w s - g Q: - l "O n?
[re]vshale	R "e w s - h %a: $ l @	R "a w s - h %a: $ l @
[re]vshøj	R "e w s - h %6 j?	R "a w s - h %6 j?
[re]vsø	R e w $ s "2:?	R a w $ s "2:?
[re]vsøre	R "e w? $ s %2: $ 6	R "a w? $ s %2: $ 6
[re]vtrille	R "e w - t R %i $ l @	R "a w - t R %i $ l @
[re]wers	R "e:? $ v 6 s	R "a:? $ v 6 s
[re]witz	R "e: $ v i d s	R "a: $ v i d s
[re]y	R "e: j	R "a: j
[re]yes	R "e $ j e s	R "a $ j e s
[re]ynolds	R "e $ n O l d s	R "a $ n O l d s
[re]za	R "e: $ s a	R "a: $ s a
Romerb[re]vet	R "o:? $ m 6 - b R %e:? $ v @ d	R "o:? $ m 6 - b R %a:? $ v @ d
Roseng[re]en	R "o: $ s @ n - g R %e:? n	R "o: $ s @ n - g R %a:? n
Roseng[re]n	R "o: $ s @ n - g R %e:? n	R "o: $ s @ n - g R %a:? n
Rønne[re]v	R "6 $ n @ - R %e w	R "6 $ n @ - R %a w
Sahlg[re]en	s "a: l - g R %e:? n	s "a: l - g R %a:? n
Sandg[re]en	s "a n - g R %e:? n	s "a n - g R %a:? n
Sandg[re]n	s "a n - g R %e:? n	s "a n - g R %a:? n
Se[re]met	s e $ R e $ m "E d	s e $ R a $ m "E d
Se[re]na	s E $ R "e: $ n a	s E $ R "a: $ n a
Shoh[re]h	S "o $ R e	S "o $ R a
Siegf[re]d	s "i: g $ f R %e D	s "i: g $ f R %a D
Sigf[re]d	s "i: $ f R %e D	s "i: $ f R %a D
Sikringssty[re]lsen	s "e $ g R e N s - s d %y: $ 6 l $ s @ n	s "e $ g R a N s - s d %y: $ 6 l $ s @ n
Sjøg[re]en	S "2 - g R %e:? n	S "2 - g R %a:? n
Sjøg[re]n	S "2 - g R %e:? n	S "2 - g R %a:? n
Skar[re]v	s g "A:? $ R %e w	s g "A:? $ R %a w
Sk[re]dtorpe	s g R "e D - t %Q: $ b @	s g R "a D - t %Q: $ b @
Sortebrød[re]stræde	s "o6 $ d @ - b R 2 D $ R 6 - s d R %e: D $ @	s "o6 $ d @ - b R 2 D $ R 6 - s d R %a: D $ @
Star[re]brink	s d "A: $ 6 - b R %e N? g	s d "A: $ 6 - b R %a N? g
Steng[re]n	s d "e: n - g R %e:? n	s d "e: n - g R %a:? n
Stoff[re]gen	s d "6 $ f R %e: $ g e n	s d "6 $ f R %a: $ g e n
St[re]bæk	s d R "e:? - b %E g	s d R "a:? - b %E g
St[re]ndur	s d R "e n $ d u6	s d R "a n $ d u6
St[re]ton	s d R "e $ t e n	s d R "a $ t e n
St[re]velshoved	s d R "e: $ v e l s - h %o: $ @ D	s d R "a: $ v e l s - h %o: $ @ D
Strømg[re]n	s d R "6 m - g R %e:? n	s d R "6 m - g R %a:? n
Svane[re]den	s v "a: $ n @ - R %e: D $ @ n	s v "a: $ n @ - R %a: D $ @ n
Sydko[re]a	s "y D - k o $ R %e: $ a	s "y D - k o $ R %a: $ a
Sydko[re]as	s "y D - k o $ R %e: $ a s	s "y D - k o $ R %a: $ a s
Sy[re]nbakken	s y $ R "e:? n - b %A $ g @ n	s y $ R "a:? n - b %A $ g @ n
Sy[re]nstien	s y $ R "e:? n - s d %i:? $ @ n	s y $ R "a:? n - s d %i:? $ @ n
Sy[re]nvej	s y $ R "e:? n - v %A j?	s y $ R "a:? n - v %A j?
Sy[re]nvænget	s y $ R "e:? n - v %E N $ @ D	s y $ R "a:? n - v %E N $ @ D
Søb[re]dden	s "2: - b R %e:? $ d @ n	s "2: - b R %a:? $ d @ n
Søderg[re]n	s "2: D $ 6 - g R %e:? n	s "2: D $ 6 - g R %a:? n
Tahe[re]h	t a $ h "E $ R e	t a $ h "E $ R a
Te[re]sa	t e $ R "e: $ s a	t e $ R "a: $ s a
Te[re]se	t e $ R "e: $ s @	t e $ R "a: $ s @
Te[re]sia	t e $ R "e:? $ S a	t e $ R "a:? $ S a
Te[re]sita	t e $ R e $ s "i $ t a	t e $ R a $ s "i $ t a
Te[re]za	t e $ R "e: $ s a	t e $ R "a: $ s a
The[re]sa	t e $ R "e: $ s a	t e $ R "a: $ s a
The[re]se	t e $ R "e: $ s @	t e $ R "a: $ s @
The[re]sia	t e $ R "e:? $ S a	t e $ R "a:? $ S a
Tilleg[re]en	t "i $ l @ - g R %e:? n	t "i $ l @ - g R %a:? n
Tomme[re]d	t "6 $ m @ - R %e D?	t "6 $ m @ - R %a D?
Tor[re]molinos	t 6 $ R e $ m o $ l "i: $ n 6 s	t 6 $ R a $ m o $ l "i: $ n 6 s
Tor[re]ns	t "6 $ R e n s	t "6 $ R a n s
T[re]ager	t R "e: - %a:? $ 6	t R "a: - %a:? $ 6
T[re]bbien	t R "e $ b j @ n	t R "a $ b j @ n
T[re]bjerg	t R "e: - b j %E6?	t R "a: - b j %E6?
T[re]enighed	t R e: - "e:? $ n i - h %e D?	t R a: - "e:? $ n i - h %e D?
T[re]gårde	t R e: - g "Q: $ 6	t R a: - g "Q: $ 6
T[re]huse	t R e: - h "u: $ s @	t R a: - h "u: $ s @
T[re]høj	t R "e: - h %6 j?	t R "a: - h %6 j?
T[re]høje	t R e: - h "6 $ j @	t R a: - h "6 $ j @
T[re]kanten	t R "e: - k %a n? $ d @ n	t R "a: - k %a n? $ d @ n
T[re]kantområdet	t R "e: - k a n d - 6 m ~ R %O: D $ @ D	t R "a: - k a n d - 6 m ~ R %O: D $ @ D
T[re]kantsområdet	t R "e: - k a n d s - 6 m ~ R %O: D $ @ D	t R "a: - k a n d s - 6 m ~ R %O: D $ @ D
T[re]klit	t R "e: - k l %i d	t R "a: - k l %i d
T[re]kløvervej	t R "e: - k l 2 w $ 6 - v %A j?	t R "a: - k l 2 w $ 6 - v %A j?
T[re]kroner	t R e - k R "o: $ n 6	t R a - k R "o: $ n 6
T[re]kronergade	t R e: - k R "o: $ n 6 - g %a: D $ @	t R a: - k R "o: $ n 6 - g %a: D $ @
T[re]kronerparken	t R e: - k R "o: $ n 6 - p %A: $ g @ n	t R a: - k R "o: $ n 6 - p %A: $ g @ n
T[re]kronervej	t R e: - k R "o: $ n 6 - v %A j?	t R a: - k R "o: $ n 6 - v %A j?
T[re]kærvej	t R "e: - k E6 - v %A j?	t R "a: - k E6 - v %A j?
T[re]mandsmarken	t R "e: - m a n s - m %A: $ g @ n	t R "a: - m a n s - m %A: $ g @ n
T[re]marksmose	t R e: - m A: g s - m "o: $ s @	t R a: - m A: g s - m "o: $ s @
T[re]schow	t R "e $ S 6 w	t R "a $ S 6 w
T[re]skelshuse	t R "e: - s g E l s - h %u: $ s @	t R "a: - s g E l s - h %u: $ s @
T[re]skelshøj	t R "e: - s g E l s - h %6 j	t R "a: - s g E l s - h %6 j
T[re]skelskov	t R "e: - s g E l - s g %6 w?	t R "a: - s g E l - s g %6 w?
T[re]spring	t R "e: - s b R %e N?	t R "a: - s b R %e N?
T[re]ssebølle	t R "e $ s @ - b %2 $ l @	t R "a $ s @ - b %2 $ l @
T[re]tommerparken	t R "e: - t 6 $ m 6 - p %A: $ g @ n	t R "a: - t 6 $ m 6 - p %A: $ g @ n
T[re]tommervej	t R "e: - t 6 $ m 6 - v %A j?	t R "a: - t 6 $ m 6 - v %A j?
T[re]tow-Loof	t R e $ t 6 w - l "o: f	t R a $ t 6 w - l "o: f
T[re]vad	t R "e: - v %a D	t R "a: - v %a D
T[re]å	t R "e: $ %O:?	t R "a: $ %O:?
T[re]årskrigen	t R "e: - Q: s - k R %i:? $ @ n	t R "a: - Q: s - k R %i:? $ @ n
Unik[re]dit	j "u $ n i $ k R e $ d %i d	j "u $ n i $ k R a $ d %i d
Ur-[re]hman	"u6 - R "e: - m %a n?	"u6 - R "a: - m %a n?
Valg[re]en	v "a l - g R %e:? n	v "a l - g R %a:? n
Vejle-F[re]dericia	v A j $ l @ - f R e D $ @ $ R "e d $ S a	v A j $ l @ - f R a D $ @ $ R "e d $ S a
Ve[re]na	v e $ R "e: $ n a	v e $ R "a: $ n a
Verneg[re]en	v "E6 $ n @ - g R %e:? n	v "E6 $ n @ - g R %a:? n
Verneg[re]n	v "E6 $ n @ - g R %e:? n	v "E6 $ n @ - g R %a:? n
Vestb[re]dden	v "E s d - b R %e D? $ @ n	v "E s d - b R %a D? $ @ n
Vestert[re]dje	v E $ s d 6 - t R "e D $ j @	v E $ s d 6 - t R "a D $ j @
Vollb[re]cht	f "6 l - b R %e g d	f "6 l - b R %a g d
V[re]nderup	v R "e n? $ @ $ R %O b	v R "a n? $ @ $ R %O b
V[re]nsted	v R "e n - s d %E D	v R "a n - s d %E D
V[re]sen	v R "e: $ s @ n	v R "a: $ s @ n
Wahlg[re]n	v "a l - g R %e:? n	v "a l - g R %a:? n
Wennerg[re]n	v "E $ n 6 - g R %e:? n	v "E $ n 6 - g R %a:? n
Werng[re]en	v "E6 n - g R %e:? n	v "E6 n - g R %a:? n
Westerg[re]en	v "E $ s d 6 - g R %e:? n	v "E $ s d 6 - g R %a:? n
Westerg[re]n	v "E $ s d 6 - g R %e:? n	v "E $ s d 6 - g R %a:? n
Wetterg[re]en	v "E $ t 6 - g R %e: n	v "E $ t 6 - g R %a: n
Wetterg[re]n	v "E $ d 6 - g R %e:? n	v "E $ d 6 - g R %a:? n
Whitb[re]ad	w "i d $ b R %e d	w "i d $ b R %a d
Wiing[re]en	v "i: n - g R %e:? n	v "i: n - g R %a:? n
W[re]dstrøm	v R "e D - s d R %6 m?	v R "a D - s d R %6 m?
Ye[re]van	j e $ R e $ v "a n	j e $ R a $ v "a n
Zag[re]b	s "A $ g R %e b	s "A $ g R %a b
Zag[re]bs	s "A $ g R %e b s	s "A $ g R %a b s
Za[re]mba	s A $ R "e m $ b a	s A $ R "a m $ b a
Zoh[re]h	s "o: $ R e	s "o: $ R a
Åg[re]n	"O:? $ g R %e:? n	"O:? $ g R %a:? n
Æbleg[re]nen	"E: $ b l @ - g R %e:? $ n @ n	"E: $ b l @ - g R %a:? $ n @ n
Ø[re]ringene	"2: $ 6 - R %e N $ @ $ n @	"2: $ 6 - R %a N $ @ $ n @
Ørne[re]devej	"96 $ n @ - R e: D $ @ - v %A j?	"96 $ n @ - R a: D $ @ - v %A j?
[re]mnick	R "e m $ n e g	R "a m $ n e g
