allerede: "a l @ R %e: D @ 
apartheidregimet.: a p "A: d h A j d R e S %i: m @ D 
bananrepublik.: b a n "a:? n R e p u b l %i g 
begrebet: b e g R "e:? b @ D 
begreb,: b e g R "e:? b 
begreb: b e g R "e:? b 
beskrev: b e s g R "e w? 
borgerrepræsentant: b "Q w 6 R e p R e s @ n t %a n? d 
bred: b R "e D? 
bredde: b R "e:? d @ 
brede: b R "e: D @ 
breder: b R "e: D 6 
bredskuldret,: b R "e D s g %u l? R 6 D 
bredt: b R "e d 
bremer: b R "e:? m 6 
bretoner.: b R e t "o:? n 6 
brev.: b R "e w? 
brevet,: b R "e:? v @ D 
brevpost.: b R "e w p %6 s d 
cd-rom-drevet.: s e: d e: R "6 m? d R %e:? v @ D 
chefredaktør,: S "E:? f R e d A g t %26? 
cirkusrevyen: s "i6 g u s R e v %y:? @ n 
cremet: k R "e: m @ D 
cremen: k R "e:? m @ n 
diskret.: d i s g R "e:? d 
dressing: d R "e s e N 
dressingen: d R "e s %e N? @ n 
dressing.: d R "e s e N 
drev: d R "e w? 
drevet: d R "e: v @ D 
dræberen.: d R "e: b 6 6 n 
ekstremt: E g s d R "e:? m d 
ekstrem: E g s d R "e:? m 
entreen.: A N t R "e:? @ n 
entre: A N t R "e 
erindrer: e R "e n? d R 6 
fagkredse: f "A w k R %e: s @ 
familiebegrebet.: f a m "i l? j @ b e g R %e:? b @ D 
fedtmarmorering.: f "e d m A m o R %e6? e N 
fintrevet: f "i:? n d R %e: v @ D 
fiskerestaurant.: f "e s g @ R e s d o R %A N 
florerer.: f l o R "e:? 6 
folkeregister: f "6 l g @ R e g %i s d 6 
fred: f R "e D? 
fredage: f R "e:? d %a: @ 
fredag: f R "e:? d a 
fredagsbøn: f R "e:? d a s b %9 n? 
fredagsbønnen: f R "e:? d a s b %9 n? @ n 
frede.: f R "e: D @ 
fredelig.: f R "e: D @ l i 
freden,: f R "e D? @ n 
fredelige: f R "e: D @ l i:? @ 
fredens: f R "e D? @ n s 
frede: f R "e: D @ 
fredning,: f R "e D n e N 
fredsommelige.: f R e D s "6 m? @ l i:? @ 
fremdrift.: f R "E m d R %e f d 
frustrerende.: f R u s d R "e:? 6 n @ 
frustreret: f R u s d R "e:? 6 D 
greb: g R "e:? b 
grebet: g R "e b @ D 
grene.: g R "e: n @ 
grev: g R "e w 
greven: g R "e: v @ n 
greve: g R "e: v @ 
groftrevet: g R "6 f d R %e: v @ D 
gøgereden: g "2: @ R %e: D @ n 
halvtreds.: h a l t R "e s 
halvtredsindstyvende: h a l t R "e s e n s t %y: v @ n @ 
halvtreds: h a l t R "e s 
harem,: h "A: R %e m? 
helbred: h "E l b R %e D 
helbredet.: h "e: l b R %e D? @ D 
idrætsgrene.: "i d R E d s g R %e: n @ 
ignorerer: i n j o R "e:? 6 
illustrerer: i l u s d R "e:? 6 
inspirerende.: e n s b i R "e:? 6 n @ 
inspirerende.: e n s b i R "e:? 6 n @ 
integrerer: e n t @ g R "e:? 6 
kastreret: k a s d R "e:? 6 D 
klaret: k l A R "e d 
koncentrerede: k 6 n s @ n t R "e:? 6 D @ 
koncentreret.: k 6 n s @ n t R "e:? 6 D 
konkret: k 6 N k R "e:? d 
koralrev: k o R "A l? R %e w 
kreationer.: k R e a S "o:? n 6 
kreativ: k R "e: a t %i w? 
kreditorer: k R e d i t "o: 6 
kredsløb: k R "e:? s l %2:? b 
kreds: k R "e:? s 
kredser: k R "e: s 6 
kulturrevolution: k u l t "u6? R e v o l u S %o:? n 
landboreformerne.: l "a n b o: R e f %Q:? m 6 n @ 
landgreven: l "a n g R %e: v @ n 
læserbrev: l "E: s 6 b R %e w? 
manøvreres.: m a n 2 w R "e:? 6 s 
memorerer: m e m o R "e:? 6 
minareter: m i n a R "e:? d 6 
miskredit.: m "i s k R e d %i d 
motivkreds: m o t "i w? k R %e:? s 
naturressourcer.: n a t "u6? R e s %u6 s 6 
nummerering.: n O m @ R "e6? e N 
oksehøjreb.: "6 g s @ h 6 j R %e:? b 
opereres.: o b @ R "e:? 6 s 
overgreb.: "6 w 6 g R %e:? b 
pilgrimsrejser: p "i l g R e m s R %A j s 6 
premiere: p R e m j "E: 6 
printere.: p R "e n d 6 6 
præcisere.: p R e s i s "e:? 6 
præsenteret: p R e s @ n t "e:? 6 D 
purer: p u R "e6? 
reagerer: R e a g "e:? 6 
reaktion: R e A g S "o:? n 
reaktionært: R "e: A g S o n %E6? d 
realisme: R e a l "i s m @ 
reallønsfremgang: R e "a:? l l 9 n s f R E m g %A N? 
rebel,: R e b "E l? 
rebus.: R "e: b u s 
red: R "e D? 
redaktion.: R e d A g S "o:? n 
redaktionschef.: R e d A g S "o:? n s S %E:? f 
redaktør,: R e d A g t "26? 
redaktion: R e d A g S "o:? n 
redaktører,: R e d A g t "2:? 6 
redde: R "e D @ 
reddede: R "e D @ D @ 
reddet: R "e D @ D 
reder.: R "e: D 6 
redigér: R e d i g "e6? 
redningsplan: R "e D n e N s p l %a:? n 
redningsbåden: R "e D n e N s b %O:? D @ n 
redt.: R "e:? d 
reelt: R e "E l? d 
reetablering: R "e e t a b l %e6? e N 
refleksioner: R e f l E g S "o:? n 6 
reform: R e f "Q:? m 
reformens: R e f "Q:? m @ n s 
reformiver: R e f "Q:? m %i:? v 6 
reformen: R e f "Q:? m @ n 
refuge.: R e f "y: S 
refugium.: R e f "u:? g j O m 
regel: R "e:? @ l 
regelmæssighed: R "e:? @ l m E s i h %e D? 
regenerere: R "e g E n @ R %e:? 6 
regeringen: R e g "e:? R e N? @ n 
regerer: R e g "e:? 6 
regering.: R e g "e6? e N 
regeres: R e g "e:? 6 s 
regi,: R e S "i 
regimet: R e S "i: m @ D 
regimets: R e S "i: m @ D s 
regina: R e g "i: n a 
region: R e g i "o:? n 
regionalnyt: R e g i o n "a:? l n %y d 
registreringsdatabasen: R e g i s d R "e6? e N s d a: t a b %a: s @ n 
registreres: R e g i s d R "e:? 6 s 
registreringseditoren: R e g i s d R "e6? e N s e d i t %Q: 6 n 
regissør: R e S i s "26? 
registreringsdatabasen: R e g i s d R "e6? e N s d a: t a b %a: s @ n 
registreringseditoren.: R e g i s d R "e6? e N s e d i t %Q: 6 n 
regler.: R "e:? l 6 
regulær: R e g u l "E6? 
regulær: R e g u l "E6? 
reklamer.: R e k l "a: m 6 
rekorden: R e k "Q: d @ n 
rekreativ: R "e k R @ a t %i w? 
rekruttering: R e k R u t "e6? e N 
rekviem: R "e:? k v i E m 
relativt: R "e l a t %i w? d 
relativ: R "e l a t %i w? 
religionen.: R e l i g j "o:? n @ n 
religionsvidenskab: R e l i g j "o:? n s v i: D @ n s g %a:? b 
religionsforsker.: R e l i g j "o:? n s f %Q: s g 6 
religiøs: R e l i g j "2:? s 
religionsrapport.: R e l i g j "o:? n s R A p %Q: d 
religiøs: R e l i g j "2:? s 
relikvier.: R e l "i:? k v i 6 
ren,: R "e:? n 
rendyrket: R "e: n d %y6 g @ D 
rene.: R "e: n @ 
rengjorte: R "e: n g j %o6? d @ 
rengøringsdame.: R "e: n g 96? e N s d %a: m @ 
rengøring: R "e: n g %96? e N 
rengøringsdame.: R "e: n g 96? e N s d %a: m @ 
renlighed: R "e: n l i h %e D? 
renovering: R e n o v "e6? e N 
rent: R "e:? n d 
renæssance: R e n @ s "A N s @ 
reparation: R e b A A S "o:? n 
repatriering.: R "e p a t R i %e6? e N 
repertoire.: R e b E6 t o "A: 
replicerede.: R e p l i s "e:? 6 D @ 
replikker: R e p l "i g 6 
reportage: R e p Q t "a: S @ 
repræsentant: R e p R e s @ n t "a n? d 
repræsentative: R e p R "e s @ n t a t %i:? v @ 
republic,: R e p "6 b l i g 
republikker: R e p u b l "i g 6 
respekt: R e s b "E g d 
respektabel: R e s b E g t "a:? b @ l 
respiration.: R e s b i A S "o:? n 
respons: R e s b "6 n? s 
ressource: R e s "u6 s @ 
ressourcer.: R e s "u6 s 6 
restaurant: R e s d o R "A N 
resultater.: R e s u l t "a:? d 6 
resultat.: R e s u l t "a:? d 
resultatet.: R e s u l t "a:? d @ D 
resultaterne: R e s u l t "a:? d 6 n @ 
retardering,: R e t A d "e6? e N 
retorisk,: R e t "o6? i s g 
revanche.: R e v "A N S 
reven: R "e: v @ n 
revet: R "e:? v @ D 
reviderer: R e v i d "e:? 6 
revolution.: R e v o l u S "o:? n 
revolution,: R e v o l u S "o:? n 
revolutionen: R e v o l u S "o:? n @ n 
revurdering.: R "e v u6 d %e6? e N 
revy,: R e v "y 
revyen.: R e v "y:? @ n 
selvregulering: s "E l R e g u l %e6? e N 
skizofreni.: s g i d s o f R e n "i:? 
skizofrent,: s g i d s o f R "e:? n d 
skrev: s g R "e w? 
skrevet: s g R "e: v @ D 
spredte: s b R "e: d @ 
spredt: s b R "e:? d 
spredehagl.: s b R "e: D @ h %A w? l 
stress: s d R "e s 
studieforberedelse.: s d "u:? d j @ f Q: b @ R %e D? @ l s @ 
studiekredsen.: s d "u:? d j @ k R %e:? s @ n 
stuerent,: s d "u: @ R %e:? n d 
stueren,: s d "u: @ R %e:? n 
tres,: t R "e s 
tres: t R "e s 
tresindstyvende: t R "e s e n s t %y: v @ n @ 
udbredt,: "u D b R %e:? d 
udbredte.: "u D b R %e:? d @ 
ugerevy,: "u: @ R e v %y 
underskrev: "O n 6 s g R %e w? 
vennekreds.: v "E n @ k R %e:? s 
vred: v R "e D? 
vreden: v R "e: D @ n 
vredet: v R "e: D @ D 
vredens: v R "e: D @ n s 
yoghurtdressing.: j "o g u6 d d R %e s e N 